key	text	tooltip
#Loc;1;text/db/campaign_group_faction_cosmetic_overrides__.loc		
campaign_group_faction_cosmetic_overrides_name_3k_main_campaign_group_cosmetic_tag_faction_name_liu_biao_4	Kingdom of Chu	false
campaign_group_faction_cosmetic_overrides_name_3k_dlc05_campaign_group_cosmetic_tag_faction_name_zang_ba_world_leader	Kingdom of Lu	false
campaign_group_faction_cosmetic_overrides_name_3k_main_campaign_group_cosmetic_tag_faction_name_xiapi_separatists_3	Duchy of Xiapi Separatists	false
campaign_group_faction_cosmetic_overrides_name_3k_main_campaign_group_cosmetic_tag_faction_name_liu_biao_separatists_3	Duchy of Chu Separatists	false
campaign_group_faction_cosmetic_overrides_name_3k_main_campaign_group_cosmetic_tag_faction_name_wudu_separatists_4	Kingdom of Wudu Separatists	false
campaign_group_faction_cosmetic_overrides_name_3k_main_campaign_group_cosmetic_tag_faction_name_daijun_3	Duchy of Daijun	false
campaign_group_faction_cosmetic_overrides_name_3k_main_campaign_group_cosmetic_tag_faction_name_yanmen_3	Duchy of Yanmen	false
campaign_group_faction_cosmetic_overrides_name_3k_main_campaign_group_cosmetic_tag_faction_name_donghai_3	Duchy of Donghai	false
campaign_group_faction_cosmetic_overrides_name_3k_main_campaign_group_cosmetic_tag_faction_name_yulin_world_leader	Kingdom of Yulin	false
campaign_group_faction_cosmetic_overrides_name_3k_main_campaign_group_cosmetic_tag_faction_name_kuaiji_separatists_4	Kingdom of Kuaiji Separatists	false
campaign_group_faction_cosmetic_overrides_name_3k_main_campaign_group_cosmetic_tag_faction_name_guangling_separatists_4	Kingdom of Guangling Separatists	false
campaign_group_faction_cosmetic_overrides_name_3k_main_campaign_group_cosmetic_tag_faction_name_liu_yan_4	Kingdom of Xun	false
campaign_group_faction_cosmetic_overrides_name_ep_campaign_group_faction_cosmetics_prince_of_xihe	Lady of Xihe	false
campaign_group_faction_cosmetic_overrides_name_ep_campaign_group_faction_cosmetics_prince_of_liaoxi_separatists	Lady of Liaoxi Separatists	false
campaign_group_faction_cosmetic_overrides_name_ep_campaign_group_faction_cosmetics_prince_of_yizhou	Lady of Yizhou	false
campaign_group_faction_cosmetic_overrides_name_3k_main_campaign_group_cosmetic_tag_faction_name_zhang_separatists_world_leader	Kingdom of Hanning Separatists	false
campaign_group_faction_cosmetic_overrides_name_ep_campaign_group_faction_cosmetics_prince_of_fanyang_separatists	Lady of Fanyang Separatists	false
campaign_group_faction_cosmetic_overrides_name_3k_main_campaign_group_cosmetic_tag_faction_name_chengdu_separatists_world_leader	Kingdom of Shu Separatists	false
campaign_group_faction_cosmetic_overrides_name_3k_main_campaign_group_cosmetic_tag_faction_name_jingzhou_separatists_world_leader	Kingdom of Jingzhou Separatists	false
campaign_group_faction_cosmetic_overrides_name_3k_main_campaign_group_cosmetic_tag_faction_name_cangwu_world_leader	Kingdom of Cangwu	false
campaign_group_faction_cosmetic_overrides_name_3k_main_campaign_group_cosmetic_tag_faction_name_rebels_4	Kingdom of Rebels	false
campaign_group_faction_cosmetic_overrides_name_3k_main_campaign_group_cosmetic_tag_faction_name_zhang_separatists_4	Kingdom of Hanning Separatists	false
campaign_group_faction_cosmetic_overrides_name_3k_main_campaign_group_cosmetic_tag_faction_name_kong_rong_separatists_3	Duchy of Qi Separatists	false
campaign_group_faction_cosmetic_overrides_name_3k_main_campaign_group_cosmetic_tag_faction_name_liu_yao_separatists_world_leader	Kingdom of Yue Separatists	false
campaign_group_faction_cosmetic_overrides_name_ep_campaign_group_faction_cosmetics_prince_of_chu_separatists	Lady of Chu Separatists	false
campaign_group_faction_cosmetic_overrides_name_3k_main_campaign_group_cosmetic_tag_faction_name_xihe_3	Duchy of Xihe	false
campaign_group_faction_cosmetic_overrides_name_ep_campaign_group_faction_cosmetics_prince_of_luling	Lady of Luling	false
campaign_group_faction_cosmetic_overrides_name_3k_main_campaign_group_cosmetic_tag_faction_name_yuan_shao_3	Duchy of Song	false
campaign_group_faction_cosmetic_overrides_name_3k_main_campaign_group_cosmetic_tag_faction_name_baxi_separatists_3	Duchy of Baxi Separatists	false
campaign_group_faction_cosmetic_overrides_name_3k_main_campaign_group_cosmetic_tag_faction_name_baxi_separatists_4	Kingdom of Baxi Separatists	false
campaign_group_faction_cosmetic_overrides_name_3k_main_campaign_group_cosmetic_tag_faction_name_lujiang_4	Kingdom of Lujiang	false
campaign_group_faction_cosmetic_overrides_name_3k_dlc04_campaign_group_cosmetic_tag_faction_name_dong_he_3	Duchy of Yi	false
campaign_group_faction_cosmetic_overrides_name_3k_main_campaign_group_cosmetic_tag_faction_name_rebels_3	Duchy of Rebels	false
campaign_group_faction_cosmetic_overrides_name_3k_main_campaign_group_cosmetic_tag_faction_name_yuzhang_3	Duchy of Yuzhang	false
campaign_group_faction_cosmetic_overrides_name_3k_main_campaign_group_cosmetic_tag_faction_name_shi_xie_world_leader	Kingdom of Jiuzhen	false
campaign_group_faction_cosmetic_overrides_name_3k_main_campaign_group_cosmetic_tag_faction_name_kong_zhou_world_leader	Kingdom of Chen	false
campaign_group_faction_cosmetic_overrides_name_3k_main_campaign_group_cosmetic_tag_faction_name_lu_su_hero_water	PH	false
campaign_group_faction_cosmetic_overrides_name_3k_main_campaign_group_cosmetic_tag_faction_name_liu_yu_separatists_3	Duchy of Daijun Separatists	false
campaign_group_faction_cosmetic_overrides_name_3k_main_campaign_group_cosmetic_tag_faction_name_guangling_3	Duchy of Guangling	false
campaign_group_faction_cosmetic_overrides_name_3k_main_campaign_group_cosmetic_tag_faction_name_yuan_shu_4	Kingdom of Zhong	false
campaign_group_faction_cosmetic_overrides_name_3k_dlc05_campaign_group_cosmetic_tag_faction_name_xu_zhao_separatists_4	Kingdom of Wu Separatists	false
campaign_group_faction_cosmetic_overrides_name_3k_main_campaign_group_cosmetic_tag_faction_name_shoufang_3	Duchy of Shuofang	false
campaign_group_faction_cosmetic_overrides_name_3k_main_campaign_group_cosmetic_tag_faction_name_runan_world_leader	Kingdom of Runan	false
campaign_group_faction_cosmetic_overrides_name_3k_main_campaign_group_cosmetic_tag_faction_name_zhang_fei_hero_fire	PH	false
campaign_group_faction_cosmetic_overrides_name_3k_main_campaign_group_cosmetic_tag_faction_name_jianning_separatists_4	Kingdom of Jianning Separatists	false
campaign_group_faction_cosmetic_overrides_name_ep_campaign_group_faction_cosmetics_prince_of_qi_separatists	Lady of Qi Separatists	false
campaign_group_faction_cosmetic_overrides_name_3k_main_campaign_group_cosmetic_tag_faction_name_beihai_separatists_4	Kingdom of Beihai Separatists	false
campaign_group_faction_cosmetic_overrides_name_3k_main_campaign_group_cosmetic_tag_faction_name_dong_separatists_3	Duchy of Zhou Separatists	false
campaign_group_faction_cosmetic_overrides_name_3k_main_campaign_group_cosmetic_tag_faction_name_shangyong_4	Kingdom of Shangyong	false
campaign_group_faction_cosmetic_overrides_name_ep_campaign_group_faction_cosmetics_prince_of_chengdu_separatists	Lady of Chengdu Separatists	false
campaign_group_faction_cosmetic_overrides_name_3k_main_campaign_group_cosmetic_tag_faction_name_ma_teng_separatists_3	Duchy of Liang Separatists	false
campaign_group_faction_cosmetic_overrides_name_3k_dlc05_campaign_group_cosmetic_tag_faction_name_lu_bu_4	Kingdom of Yin	false
campaign_group_faction_cosmetic_overrides_name_3k_main_campaign_group_cosmetic_tag_faction_name_sima_yi_hero_water	Jin	false
campaign_group_faction_cosmetic_overrides_name_3k_main_campaign_group_cosmetic_tag_faction_name_sheng_xian_separatists_world_leader	Kingdom of Wu Separatists	false
campaign_group_faction_cosmetic_overrides_name_3k_main_campaign_group_cosmetic_tag_faction_name_hedong_separatists_world_leader	Kingdom of Hedong Separatists	false
campaign_group_faction_cosmetic_overrides_name_3k_main_campaign_group_cosmetic_tag_faction_name_guangling_world_leader	Kingdom of Guangling	false
campaign_group_faction_cosmetic_overrides_name_ep_campaign_group_faction_cosmetics_prince_of_pingyuan	Lady of Pingyuan	false
campaign_group_faction_cosmetic_overrides_name_3k_main_campaign_group_cosmetic_tag_faction_name_tao_qian_hero_water	PH	false
campaign_group_faction_cosmetic_overrides_name_3k_main_campaign_group_cosmetic_tag_faction_name_shangdang_separatists_3	Duchy of Shangdang Separatists	false
campaign_group_faction_cosmetic_overrides_name_3k_main_campaign_group_cosmetic_tag_faction_name_cai_mao_4	Kingdom of Cai	false
campaign_group_faction_cosmetic_overrides_name_3k_main_campaign_group_cosmetic_tag_faction_name_donghai_separatists_3	Duchy of Donghai Separatists	false
campaign_group_faction_cosmetic_overrides_name_ep_campaign_group_faction_cosmetics_prince_of_badong_separatists	Lady of Badong Separatists	false
campaign_group_faction_cosmetic_overrides_name_ep_campaign_group_faction_cosmetics_prince_of_gaoliang	Lady of Gaoliang	false
campaign_group_faction_cosmetic_overrides_name_3k_main_campaign_group_cosmetic_tag_faction_name_kong_zhou_separatists_world_leader	Kingdom of Chen Separatists	false
campaign_group_faction_cosmetic_overrides_name_3k_main_campaign_group_cosmetic_tag_faction_name_luling_3	Duchy of Luling	false
campaign_group_faction_cosmetic_overrides_name_ep_campaign_group_faction_cosmetics_prince_of_cangwu_separatists	Lady of Cangwu Separatists	false
campaign_group_faction_cosmetic_overrides_name_3k_dlc04_campaign_group_cosmetic_tag_faction_name_zhou_xin_3	Duchy of Jiujiang	false
campaign_group_faction_cosmetic_overrides_name_3k_main_campaign_group_cosmetic_tag_faction_name_han_fu_4	Kingdom of Nie	false
campaign_group_faction_cosmetic_overrides_name_3k_dlc05_campaign_group_cosmetic_tag_faction_name_white_tiger_yan_3	Duchy of Yue	false
campaign_group_faction_cosmetic_overrides_name_3k_dlc05_campaign_group_cosmetic_tag_faction_name_white_tiger_yan_separatists_world_leader	Kingdom of Yue Separatists	false
campaign_group_faction_cosmetic_overrides_name_3k_dlc05_campaign_group_cosmetic_tag_faction_name_lu_bu_world_leader	Kingdom of Yin	false
campaign_group_faction_cosmetic_overrides_name_ep_campaign_group_faction_cosmetics_prince_of_yan	Lady of Yan	false
campaign_group_faction_cosmetic_overrides_name_3k_main_campaign_group_cosmetic_tag_faction_name_pingyuan_separatists_world_leader	Kingdom of Pingyuan Separatists	false
campaign_group_faction_cosmetic_overrides_name_3k_dlc04_campaign_group_cosmetic_tag_faction_name_liang_rebels_3	Duchy of Longxi	false
campaign_group_faction_cosmetic_overrides_name_3k_dlc04_campaign_group_cosmetic_tag_faction_name_dong_he_world_leader	Kingdom of Yi	false
campaign_group_faction_cosmetic_overrides_name_3k_dlc04_campaign_group_cosmetic_tag_faction_name_xin_xuan_3	Duchy of Jing	false
campaign_group_faction_cosmetic_overrides_name_3k_main_campaign_group_cosmetic_tag_faction_name_liu_biao_separatists_4	Kingdom of Chu Separatists	false
campaign_group_faction_cosmetic_overrides_name_3k_main_campaign_group_cosmetic_tag_faction_name_jiangyang_separatists_3	Duchy of Jiangyang Separatists	false
campaign_group_faction_cosmetic_overrides_name_3k_main_campaign_group_cosmetic_tag_faction_name_beihai_separatists_world_leader	Kingdom of Beihai Separatists	false
campaign_group_faction_cosmetic_overrides_name_3k_main_campaign_group_cosmetic_tag_faction_name_liu_yan_3	Duchy of Xun	false
campaign_group_faction_cosmetic_overrides_name_3k_main_campaign_group_cosmetic_tag_faction_name_xiapi_3	Duchy of Xiapi	false
campaign_group_faction_cosmetic_overrides_name_3k_dlc05_campaign_group_cosmetic_tag_faction_name_zang_ba_3	Duchy of Lu	false
campaign_group_faction_cosmetic_overrides_name_3k_main_campaign_group_cosmetic_tag_faction_name_gongsun_du_3	Duchy of Guzhu	false
campaign_group_faction_cosmetic_overrides_name_3k_main_campaign_group_cosmetic_tag_faction_name_youbeiping_world_leader	Kingdom of Youbeiping	false
campaign_group_faction_cosmetic_overrides_name_3k_main_campaign_group_cosmetic_tag_faction_name_dongou_separatists_3	Duchy of Linhai Separatists	false
campaign_group_faction_cosmetic_overrides_name_3k_main_campaign_group_cosmetic_tag_faction_name_anping_separatists_4	Kingdom of Anping Separatists	false
campaign_group_faction_cosmetic_overrides_name_3k_main_campaign_group_cosmetic_tag_faction_name_liaodong_3	Duchy of Liaodong	false
campaign_group_faction_cosmetic_overrides_name_3k_main_campaign_group_cosmetic_tag_faction_name_wuwei_4	Kingdom of Wuwei	false
campaign_group_faction_cosmetic_overrides_name_3k_main_campaign_group_cosmetic_tag_faction_name_wang_lang_4	Kingdom of Tan	false
campaign_group_faction_cosmetic_overrides_name_3k_main_campaign_group_cosmetic_tag_faction_name_jincheng_separatists_world_leader	Kingdom of Jincheng Separatists	false
campaign_group_faction_cosmetic_overrides_name_3k_main_campaign_group_cosmetic_tag_faction_name_poyang_separatists_3	Duchy of Poyang Separatists	false
campaign_group_faction_cosmetic_overrides_name_ep_campaign_group_faction_cosmetics_prince_of_nanhai	Lady of Nanhai	false
campaign_group_faction_cosmetic_overrides_name_3k_main_campaign_group_cosmetic_tag_faction_name_hedong_separatists_4	Kingdom of Hedong Separatists	false
campaign_group_faction_cosmetic_overrides_name_3k_main_campaign_group_cosmetic_tag_faction_name_jia_long_3	Duchy of Jianwei	false
campaign_group_faction_cosmetic_overrides_name_3k_main_campaign_group_cosmetic_tag_faction_name_luling_separatists_world_leader	Kingdom of Luling Separatists	false
campaign_group_faction_cosmetic_overrides_name_3k_main_campaign_group_cosmetic_tag_faction_name_lingling_separatists_world_leader	Kingdom of Lingling Separatists	false
campaign_group_faction_cosmetic_overrides_name_3k_main_campaign_group_cosmetic_tag_faction_name_zhang_yan_3	Duchy of Heishan	false
campaign_group_faction_cosmetic_overrides_name_3k_main_campaign_group_cosmetic_tag_faction_name_wang_lang_world_leader	Kingdom of Tan	false
campaign_group_faction_cosmetic_overrides_name_3k_dlc05_campaign_group_cosmetic_tag_faction_name_shi_wu_world_leader	Kingdom of Nanhai	false
campaign_group_faction_cosmetic_overrides_name_3k_dlc05_campaign_group_cosmetic_tag_faction_name_zang_ba_separatists_world_leader	Kingdom of Lu Separatists	false
campaign_group_faction_cosmetic_overrides_name_3k_dlc05_campaign_group_cosmetic_tag_faction_name_hua_xin_4	Kingdom of Huainan	false
campaign_group_faction_cosmetic_overrides_name_3k_main_campaign_group_cosmetic_tag_faction_name_donglai_4	Kingdom of Donglai	false
campaign_group_faction_cosmetic_overrides_name_3k_dlc04_campaign_group_cosmetic_tag_faction_name_wang_rui_3	Duchy of Xu	false
campaign_group_faction_cosmetic_overrides_name_3k_dlc04_campaign_group_cosmetic_tag_faction_name_ying_shao_3	Duchy of Xiapi	false
campaign_group_faction_cosmetic_overrides_name_3k_main_campaign_group_cosmetic_tag_faction_name_penchang_separatists_world_leader	Kingdom of Pengcheng Separatists	false
campaign_group_faction_cosmetic_overrides_name_3k_main_campaign_group_cosmetic_tag_faction_name_liu_biao_hero_earth	PH	false
campaign_group_faction_cosmetic_overrides_name_3k_main_campaign_group_cosmetic_tag_faction_name_daijun_world_leader	Kingdom of Daijun	false
campaign_group_faction_cosmetic_overrides_name_3k_dlc04_campaign_group_cosmetic_tag_faction_name_lu_kang_3	Duchy of Guiyang	false
campaign_group_faction_cosmetic_overrides_name_3k_main_campaign_group_cosmetic_tag_faction_name_hanzhong_world_leader	Kingdom of Hanzhong	false
campaign_group_faction_cosmetic_overrides_name_3k_main_campaign_group_cosmetic_tag_faction_name_gongsun_zan_hero_fire	PH	false
campaign_group_faction_cosmetic_overrides_name_3k_main_campaign_group_cosmetic_tag_faction_name_jiangxia_separatists_3	Duchy of Jiangxia Separatists	false
campaign_group_faction_cosmetic_overrides_name_3k_dlc05_campaign_group_cosmetic_tag_faction_name_xue_li_3	Duchy of Zhongli	false
campaign_group_faction_cosmetic_overrides_name_3k_main_campaign_group_cosmetic_tag_faction_name_shoufang_separatists_4	Kingdom of Shuofang Separatists	false
campaign_group_faction_cosmetic_overrides_name_3k_main_campaign_group_cosmetic_tag_faction_name_runan_3	Duchy of Runan	false
campaign_group_faction_cosmetic_overrides_name_3k_dlc04_campaign_group_cosmetic_tag_faction_name_lu_zhi_3	Duchy of Guangyang	false
campaign_group_faction_cosmetic_overrides_name_3k_main_campaign_group_cosmetic_tag_faction_name_liaodong_4	Kingdom of Liaodong	false
campaign_group_faction_cosmetic_overrides_name_3k_main_campaign_group_cosmetic_tag_faction_name_yangzhou_world_leader	Kingdom of Huainan	false
campaign_group_faction_cosmetic_overrides_name_3k_main_campaign_group_cosmetic_tag_faction_name_xiapi_separatists_world_leader	Kingdom of Xiapi Separatists	false
campaign_group_faction_cosmetic_overrides_name_3k_main_campaign_group_cosmetic_tag_faction_name_sheng_xian_3	Duchy of Wu	false
campaign_group_faction_cosmetic_overrides_name_3k_main_campaign_group_cosmetic_tag_faction_name_liaodong_separatists_4	Kingdom of Liaodong Separatists	false
campaign_group_faction_cosmetic_overrides_name_3k_main_campaign_group_cosmetic_tag_faction_name_kong_rong_hero_water	PH	false
campaign_group_faction_cosmetic_overrides_name_3k_main_campaign_group_cosmetic_tag_faction_name_lingling_4	Kingdom of Lingling	false
campaign_group_faction_cosmetic_overrides_name_3k_dlc04_campaign_group_cosmetic_tag_faction_name_lu_kang_separatists_3	Duchy of Guiyang Separatists	false
campaign_group_faction_cosmetic_overrides_name_3k_dlc04_campaign_group_cosmetic_tag_faction_name_liu_hong_4	Kingdom of Nan	false
campaign_group_faction_cosmetic_overrides_name_3k_dlc05_campaign_group_cosmetic_tag_faction_name_shi_huang_world_leader	Kingdom of Cangwu	false
campaign_group_faction_cosmetic_overrides_name_3k_main_campaign_group_cosmetic_tag_faction_name_shi_xie_hero_water	PH	false
campaign_group_faction_cosmetic_overrides_name_3k_main_campaign_group_cosmetic_tag_faction_name_dong_zhuo_hero_fire	PH	false
campaign_group_faction_cosmetic_overrides_name_3k_main_campaign_group_cosmetic_tag_faction_name_tong'an_separatists_4	Kingdom of Tong'an Separatists	false
campaign_group_faction_cosmetic_overrides_name_3k_main_campaign_group_cosmetic_tag_faction_name_liu_dai_world_leader	Kingdom of Tang	false
campaign_group_faction_cosmetic_overrides_name_3k_main_campaign_group_cosmetic_tag_faction_name_liu_yao_separatists_4	Kingdom of Yue Separatists	false
campaign_group_faction_cosmetic_overrides_name_3k_main_campaign_group_cosmetic_tag_faction_name_jiangxia_separatists_world_leader	Kingdom of Jiangxia Separatists	false
campaign_group_faction_cosmetic_overrides_name_ep_campaign_group_faction_cosmetics_prince_of_jianan_separatists	Lady of Jian’an Separatists	false
campaign_group_faction_cosmetic_overrides_name_ep_campaign_group_faction_cosmetics_prince_of_zhongshan	Lady of Zhongshan	false
campaign_group_faction_cosmetic_overrides_name_3k_dlc04_campaign_group_cosmetic_tag_faction_name_ding_yuan_world_leader	Kingdom of Bing	false
campaign_group_faction_cosmetic_overrides_name_3k_dlc05_campaign_group_cosmetic_tag_faction_name_hua_xin_separatists_3	Duchy of Huainan Separatists	false
campaign_group_faction_cosmetic_overrides_name_3k_main_campaign_group_cosmetic_tag_faction_name_changan_3	Duchy of Jingzhao	false
campaign_group_faction_cosmetic_overrides_name_3k_main_campaign_group_cosmetic_tag_faction_name_jiangyang_4	Kingdom of Jiangyang	false
campaign_group_faction_cosmetic_overrides_name_3k_main_campaign_group_cosmetic_tag_faction_name_ye_4	Kingdom of Ye	false
campaign_group_faction_cosmetic_overrides_name_3k_main_campaign_group_cosmetic_tag_faction_name_hepu_separatists_world_leader	Kingdom of Hepu Separatists	false
campaign_group_faction_cosmetic_overrides_name_ep_campaign_group_faction_cosmetics_prince_of_pingyuan_separatists	Lady of Pingyuan Separatists	false
campaign_group_faction_cosmetic_overrides_name_3k_main_campaign_group_cosmetic_tag_faction_name_jianan_3	Duchy of Jian'an	false
campaign_group_faction_cosmetic_overrides_name_3k_dlc04_campaign_group_cosmetic_tag_faction_name_prince_liu_chong_separatists_4	Kingdom of Chen Separatists	false
campaign_group_faction_cosmetic_overrides_name_3k_main_campaign_group_cosmetic_tag_faction_name_zhai_rong_separatists_4	Kingdom of Chao Separatists	false
campaign_group_faction_cosmetic_overrides_name_3k_main_campaign_group_cosmetic_tag_faction_name_yangzhou_separatists_world_leader	Kingdom of Huainan Separatists	false
campaign_group_faction_cosmetic_overrides_name_ep_campaign_group_faction_cosmetics_prince_of_liang	Lady of Liang	false
campaign_group_faction_cosmetic_overrides_name_3k_main_campaign_group_cosmetic_tag_faction_name_nanhai_4	Kingdom of Nanhai	false
campaign_group_faction_cosmetic_overrides_name_3k_main_campaign_group_cosmetic_tag_faction_name_liu_bei_hero_earth	PH	false
campaign_group_faction_cosmetic_overrides_name_3k_main_campaign_group_cosmetic_tag_faction_name_dongou_3	Duchy of Linhai	false
campaign_group_faction_cosmetic_overrides_name_3k_main_campaign_group_cosmetic_tag_faction_name_yizhou_world_leader	Kingdom of Yizhou	false
campaign_group_faction_cosmetic_overrides_name_ep_campaign_group_faction_cosmetics_prince_of_engcheng	Lady of Pengcheng	false
campaign_group_faction_cosmetic_overrides_name_3k_main_campaign_group_cosmetic_tag_faction_name_bohai_separatists_3	Duchy of Bohai Separatists	false
campaign_group_faction_cosmetic_overrides_name_3k_main_campaign_group_cosmetic_tag_faction_name_wuling_world_leader	Kingdom of Wuling	false
campaign_group_faction_cosmetic_overrides_name_3k_main_campaign_group_cosmetic_tag_faction_name_youzhou_separatists_4	Kingdom of Guangyang Separatists	false
campaign_group_faction_cosmetic_overrides_name_3k_main_campaign_group_cosmetic_tag_faction_name_taiyuan_separatists_world_leader	Kingdom of Taiyuan Separatists	false
campaign_group_faction_cosmetic_overrides_name_3k_main_campaign_group_cosmetic_tag_faction_name_nanyang_separatists_3	Duchy of Nanyang Separatists	false
campaign_group_faction_cosmetic_overrides_name_3k_main_campaign_group_cosmetic_tag_faction_name_wuwei_separatists_world_leader	Kingdom of Wuwei Separatists	false
campaign_group_faction_cosmetic_overrides_name_3k_main_campaign_group_cosmetic_tag_faction_name_gao_gan_world_leader	Kingdom of Bing	false
campaign_group_faction_cosmetic_overrides_name_3k_dlc04_campaign_group_cosmetic_tag_faction_name_liang_rebels_separatists_3	Duchy of Longxi Separatists	false
campaign_group_faction_cosmetic_overrides_name_3k_main_campaign_group_cosmetic_tag_faction_name_weijun_4	Kingdom of Weijun	false
campaign_group_faction_cosmetic_overrides_name_3k_dlc05_campaign_group_cosmetic_tag_faction_name_yang_feng_4	Kingdom of Wey	false
campaign_group_faction_cosmetic_overrides_name_3k_main_campaign_group_cosmetic_tag_faction_name_zangke_3	Duchy of Zangke	false
campaign_group_faction_cosmetic_overrides_name_3k_main_campaign_group_cosmetic_tag_faction_name_gongsun_separatists_3	Duchy of Yan Separatists	false
campaign_group_faction_cosmetic_overrides_name_3k_main_campaign_group_cosmetic_tag_faction_name_yuzhang_separatists_3	Duchy of Yuzhang Separatists	false
campaign_group_faction_cosmetic_overrides_name_ep_campaign_group_faction_cosmetics_prince_of_changan_separatists	Lady of Chang’an Separatists	false
campaign_group_faction_cosmetic_overrides_name_3k_main_campaign_group_cosmetic_tag_faction_name_zheng_jiang_world_leader	Tai Dominion	false
campaign_group_faction_cosmetic_overrides_name_3k_dlc05_campaign_group_cosmetic_tag_faction_name_xu_zhao_separatists_3	Duchy of Wu Separatists	false
campaign_group_faction_cosmetic_overrides_name_3k_main_campaign_group_cosmetic_tag_faction_name_donglai_separatists_4	Kingdom of Donglai Separatists	false
campaign_group_faction_cosmetic_overrides_name_ep_campaign_group_faction_cosmetics_prince_of_beihai_separatists	Lady of Beihai Separatists	false
campaign_group_faction_cosmetic_overrides_name_3k_main_campaign_group_cosmetic_tag_faction_name_lujiang_separatists_4	Kingdom of Lujiang Separatists	false
campaign_group_faction_cosmetic_overrides_name_3k_dlc05_campaign_group_cosmetic_tag_faction_name_zhu_fu_separatists_world_leader	Kingdom of Kui Separatists	false
campaign_group_faction_cosmetic_overrides_name_3k_dlc04_campaign_group_cosmetic_tag_faction_name_cao_song_separatists_3	Duchy of Yang Separatists	false
campaign_group_faction_cosmetic_overrides_name_3k_main_campaign_group_cosmetic_tag_faction_name_lady_sun_shangxiang_hero_fire	PH	false
campaign_group_faction_cosmetic_overrides_name_ep_campaign_group_faction_cosmetics_prince_of_yanmen_separatists	Lady of Yanmen Separatists	false
campaign_group_faction_cosmetic_overrides_name_3k_main_campaign_group_cosmetic_tag_faction_name_langye_separatists_world_leader	Kingdom of Langye Separatists	false
campaign_group_faction_cosmetic_overrides_name_3k_main_campaign_group_cosmetic_tag_faction_name_gongsun_du_world_leader	Kingdom of Guzhu	false
campaign_group_faction_cosmetic_overrides_name_3k_main_campaign_group_cosmetic_tag_faction_name_yuan_shao_4	Kingdom of Song	false
campaign_group_faction_cosmetic_overrides_name_ep_campaign_group_faction_cosmetics_prince_of_xinye	Lady of Xinye	false
campaign_group_faction_cosmetic_overrides_name_ep_campaign_group_faction_cosmetics_prince_of_xindu	Lady of Xindu	false
campaign_group_faction_cosmetic_overrides_name_3k_main_campaign_group_cosmetic_tag_faction_name_sheng_xian_world_leader	Kingdom of Wu	false
campaign_group_faction_cosmetic_overrides_name_3k_main_campaign_group_cosmetic_tag_faction_name_henei_3	Duchy of Henei	false
campaign_group_faction_cosmetic_overrides_name_3k_main_campaign_group_cosmetic_tag_faction_name_runan_separatists_4	Kingdom of Runan Separatists	false
campaign_group_faction_cosmetic_overrides_name_ep_campaign_group_faction_cosmetics_prince_of_yiyang	Lady of Yiyang	false
campaign_group_faction_cosmetic_overrides_name_3k_main_campaign_group_cosmetic_tag_faction_name_zangke_4	Kingdom of Zangke	false
campaign_group_faction_cosmetic_overrides_name_3k_main_campaign_group_cosmetic_tag_faction_name_ma_teng_world_leader	Kingdom of Liang	false
campaign_group_faction_cosmetic_overrides_name_3k_main_campaign_group_cosmetic_tag_faction_name_sun_quan_hero_earth	PH	false
campaign_group_faction_cosmetic_overrides_name_3k_main_campaign_group_cosmetic_tag_faction_name_liu_yao_4	Kingdom of Yue	false
campaign_group_faction_cosmetic_overrides_name_3k_main_campaign_group_cosmetic_tag_faction_name_yuan_shu_hero_earth	PH	false
campaign_group_faction_cosmetic_overrides_name_3k_main_campaign_group_cosmetic_tag_faction_name_tao_qian_separatists_world_leader	Kingdom of Lu Separatists	false
campaign_group_faction_cosmetic_overrides_name_3k_dlc04_campaign_group_cosmetic_tag_faction_name_zhou_xin_world_leader	Kingdom of Jiujiang	false
campaign_group_faction_cosmetic_overrides_name_3k_dlc05_campaign_group_cosmetic_tag_faction_name_shi_huang_separatists_3	Duchy of Cangwu Separatists	false
campaign_group_faction_cosmetic_overrides_name_3k_main_campaign_group_cosmetic_tag_faction_name_xindu_world_leader	Kingdom of Xindu	false
campaign_group_faction_cosmetic_overrides_name_3k_main_campaign_group_cosmetic_tag_faction_name_changsha_4	Kingdom of Changsha	false
campaign_group_faction_cosmetic_overrides_name_3k_main_campaign_group_cosmetic_tag_faction_name_runan_separatists_world_leader	Kingdom of Runan Separatists	false
campaign_group_faction_cosmetic_overrides_name_3k_main_campaign_group_cosmetic_tag_faction_name_xiangyang_separatists_3	Duchy of Xiangyang Separatists	false
campaign_group_faction_cosmetic_overrides_name_3k_main_campaign_group_cosmetic_tag_faction_name_kong_rong_separatists_world_leader	Kingdom of Qi Separatists	false
campaign_group_faction_cosmetic_overrides_name_3k_main_campaign_group_cosmetic_tag_faction_name_hepu_separatists_4	Kingdom of Hepu Separatists	false
campaign_group_faction_cosmetic_overrides_name_3k_main_campaign_group_cosmetic_tag_faction_name_shangdang_4	Kingdom of Shangdang	false
campaign_group_faction_cosmetic_overrides_name_3k_dlc04_campaign_group_cosmetic_tag_faction_name_qiao_mao_separatists_world_leader	Kingdom of Dong Separatists	false
campaign_group_faction_cosmetic_overrides_name_3k_main_campaign_group_cosmetic_tag_faction_name_shangdang_world_leader	Kingdom of Shangdang	false
campaign_group_faction_cosmetic_overrides_name_3k_main_campaign_group_cosmetic_tag_faction_name_fuling_world_leader	Kingdom of Fuling	false
campaign_group_faction_cosmetic_overrides_name_3k_main_campaign_group_cosmetic_tag_faction_name_tong'an_separatists_world_leader	Kingdom of Tong'an Separatists	false
campaign_group_faction_cosmetic_overrides_name_3k_main_campaign_group_cosmetic_tag_faction_name_gan_ning_hero_fire	PH	false
campaign_group_faction_cosmetic_overrides_name_3k_main_campaign_group_cosmetic_tag_faction_name_guangling_separatists_world_leader	Kingdom of Guangling Separatists	false
campaign_group_faction_cosmetic_overrides_name_3k_main_campaign_group_cosmetic_tag_faction_name_xiapi_world_leader	Kingdom of Xiapi	false
campaign_group_faction_cosmetic_overrides_name_3k_main_campaign_group_cosmetic_tag_faction_name_daijun_separatists_3	Duchy of Daijun Separatists	false
campaign_group_faction_cosmetic_overrides_name_3k_main_campaign_group_cosmetic_tag_faction_name_taiyuan_separatists_4	Kingdom of Taiyuan Separatists	false
campaign_group_faction_cosmetic_overrides_name_3k_main_campaign_group_cosmetic_tag_faction_name_yuzhang_4	Kingdom of Yuzhang	false
campaign_group_faction_cosmetic_overrides_name_ep_campaign_group_faction_cosmetics_prince_of_fuling_separatists	Lady of Fuling Separatists	false
campaign_group_faction_cosmetic_overrides_name_3k_main_campaign_group_cosmetic_tag_faction_name_anding_separatists_3	Duchy of Anding Separatists	false
campaign_group_faction_cosmetic_overrides_name_3k_main_campaign_group_cosmetic_tag_faction_name_yanmen_separatists_4	Kingdom of Yanmen Separatists	false
campaign_group_faction_cosmetic_overrides_name_3k_main_campaign_group_cosmetic_tag_faction_name_jingzhou_4	Kingdom of Jingzhou	false
campaign_group_faction_cosmetic_overrides_name_ep_campaign_group_faction_cosmetics_prince_of_longxi	Lady of Longxi	false
campaign_group_faction_cosmetic_overrides_name_ep_campaign_group_faction_cosmetics_prince_of_dongan_separatists	Lady of Dongan Separatists	false
campaign_group_faction_cosmetic_overrides_name_3k_main_campaign_group_cosmetic_tag_faction_name_jiangxia_world_leader	Kingdom of Jiangxia	false
campaign_group_faction_cosmetic_overrides_name_3k_main_campaign_group_cosmetic_tag_faction_name_dongou_4	Kingdom of Linhai	false
campaign_group_faction_cosmetic_overrides_name_3k_dlc05_campaign_group_cosmetic_tag_faction_name_yang_feng_separatists_world_leader	Kingdom of Wey Separatists	false
campaign_group_faction_cosmetic_overrides_name_3k_main_campaign_group_cosmetic_tag_faction_name_zhuge_liang_hero_water	PH	false
campaign_group_faction_cosmetic_overrides_name_3k_dlc05_campaign_group_cosmetic_tag_faction_name_xu_zhao_separatists_world_leader	Kingdom of Wu Separatists	false
campaign_group_faction_cosmetic_overrides_name_3k_main_campaign_group_cosmetic_tag_faction_name_jiaozhi_separatists_4	Kingdom of Jiaozhi Separatists	false
campaign_group_faction_cosmetic_overrides_name_3k_dlc05_campaign_group_cosmetic_tag_faction_name_tian_kai_separatists_world_leader	Kingdom of Zhao Separatists	false
campaign_group_faction_cosmetic_overrides_name_3k_main_campaign_group_cosmetic_tag_faction_name_han_fu_world_leader	Kingdom of Nie	false
campaign_group_faction_cosmetic_overrides_name_3k_dlc04_campaign_group_cosmetic_tag_faction_name_chen_gui_separatists_3	Duchy of Qing Separatists	false
campaign_group_faction_cosmetic_overrides_name_3k_main_campaign_group_cosmetic_tag_faction_name_gaoliang_separatists_3	Duchy of Gaoliang Separatists	false
campaign_group_faction_cosmetic_overrides_name_3k_main_campaign_group_cosmetic_tag_faction_name_yingchuan_4	Kingdom of Yingchuan	false
campaign_group_faction_cosmetic_overrides_name_3k_main_campaign_group_cosmetic_tag_faction_name_gongsun_du_separatists_world_leader	Kingdom of Guzhu Separatists	false
campaign_group_faction_cosmetic_overrides_name_3k_main_campaign_group_cosmetic_tag_faction_name_daijun_separatists_world_leader	Kingdom of Daijun Separatists	false
campaign_group_faction_cosmetic_overrides_name_3k_main_campaign_group_cosmetic_tag_faction_name_youbeiping_separatists_world_leader	Kingdom of Youbeiping Separatists	false
campaign_group_faction_cosmetic_overrides_name_ep_campaign_group_faction_cosmetics_prince_of_chengdu	Lady of Chengdu	false
campaign_group_faction_cosmetic_overrides_name_3k_main_campaign_group_cosmetic_tag_faction_name_sun_jian_3	Duchy of Wu	false
campaign_group_faction_cosmetic_overrides_name_3k_main_campaign_group_cosmetic_tag_faction_name_shangyong_separatists_world_leader	Kingdom of Shangyong Separatists	false
campaign_group_faction_cosmetic_overrides_name_3k_main_campaign_group_cosmetic_tag_faction_name_han_sui_separatists_3	Duchy of Zhai Separatists	false
campaign_group_faction_cosmetic_overrides_name_3k_main_campaign_group_cosmetic_tag_faction_name_tao_qian_separatists_3	Duchy of Lu Separatists	false
campaign_group_faction_cosmetic_overrides_name_3k_main_campaign_group_cosmetic_tag_faction_name_jiaozhi_4	Kingdom of Jiaozhi	false
campaign_group_faction_cosmetic_overrides_name_3k_main_campaign_group_cosmetic_tag_faction_name_xiapi_4	Kingdom of Xiapi	false
campaign_group_faction_cosmetic_overrides_name_ep_campaign_group_faction_cosmetics_prince_of_liang_separatists	Lady of Liang Separatists	false
campaign_group_faction_cosmetic_overrides_name_3k_main_campaign_group_cosmetic_tag_faction_name_liu_yu_separatists_4	Kingdom of Daijun Separatists	false
campaign_group_faction_cosmetic_overrides_name_3k_main_campaign_group_cosmetic_tag_faction_name_zhang_chao_separatists_3	Duchy of Zhongwu Separatists	false
campaign_group_faction_cosmetic_overrides_name_3k_main_campaign_group_cosmetic_tag_faction_name_liu_dai_separatists_4	Kingdom of Tang Separatists	false
campaign_group_faction_cosmetic_overrides_name_3k_dlc05_campaign_group_cosmetic_tag_faction_name_xu_zhao_world_leader	Kingdom of Wu	false
campaign_group_faction_cosmetic_overrides_name_3k_main_campaign_group_cosmetic_tag_faction_name_gao_gan_4	Kingdom of Bing	false
campaign_group_faction_cosmetic_overrides_name_3k_main_campaign_group_cosmetic_tag_faction_name_yulin_3	Duchy of Yulin	false
campaign_group_faction_cosmetic_overrides_name_3k_main_campaign_group_cosmetic_tag_faction_name_pingyuan_3	Duchy of Pingyuan	false
campaign_group_faction_cosmetic_overrides_name_3k_main_campaign_group_cosmetic_tag_faction_name_taishan_3	Duchy of Lean	false
campaign_group_faction_cosmetic_overrides_name_3k_main_campaign_group_cosmetic_tag_faction_name_bohai_separatists_world_leader	Kingdom of Bohai Separatists	false
campaign_group_faction_cosmetic_overrides_name_ep_campaign_group_faction_cosmetics_prince_of_tongan	Lady of Tong’an	false
campaign_group_faction_cosmetic_overrides_name_ep_campaign_group_faction_cosmetics_all_eight_princes_except_jin		false
campaign_group_faction_cosmetic_overrides_name_ep_campaign_group_faction_cosmetics_prince_of_tongan_separatists	Lady of Tong’an Separatists	false
campaign_group_faction_cosmetic_overrides_name_3k_main_campaign_group_cosmetic_tag_faction_name_lady_bian_huilan_hero_wood	PH	false
campaign_group_faction_cosmetic_overrides_name_3k_main_campaign_group_cosmetic_tag_faction_name_wang_kuang_3	Duchy of Wang	false
campaign_group_faction_cosmetic_overrides_name_3k_main_campaign_group_cosmetic_tag_faction_name_gao_gan_3	Duchy of Bing	false
campaign_group_faction_cosmetic_overrides_name_3k_main_campaign_group_cosmetic_tag_faction_name_lingling_separatists_3	Duchy of Lingling Separatists	false
campaign_group_faction_cosmetic_overrides_name_3k_main_campaign_group_cosmetic_tag_faction_name_yuan_shu_world_leader	Kingdom of Zhong	false
campaign_group_faction_cosmetic_overrides_name_ep_campaign_group_faction_cosmetics_prince_of_xiapi_separatists	Lady of Xiapi Separatists	false
campaign_group_faction_cosmetic_overrides_name_ep_campaign_group_faction_cosmetics_prince_of_han_separatists	Lady of Han Separatists	false
campaign_group_faction_cosmetic_overrides_name_3k_dlc05_campaign_group_cosmetic_tag_faction_name_tian_kai_world_leader	Kingdom of Zhao	false
campaign_group_faction_cosmetic_overrides_name_3k_main_campaign_group_cosmetic_tag_faction_name_nanhai_3	Duchy of Nanhai	false
campaign_group_faction_cosmetic_overrides_name_3k_dlc04_campaign_group_cosmetic_tag_faction_name_qiao_mao_3	Duchy of Dong	false
campaign_group_faction_cosmetic_overrides_name_3k_main_campaign_group_cosmetic_tag_faction_name_yanmen_world_leader	Kingdom of Yanmen	false
campaign_group_faction_cosmetic_overrides_name_3k_main_campaign_group_cosmetic_tag_faction_name_changan_separatists_3	Duchy of Jingzhao Separatists	false
campaign_group_faction_cosmetic_overrides_name_3k_main_campaign_group_cosmetic_tag_faction_name_dongou_world_leader	Kingdom of Linhai	false
campaign_group_faction_cosmetic_overrides_name_3k_main_campaign_group_cosmetic_tag_faction_name_kong_rong_world_leader	Kingdom of Qi	false
campaign_group_faction_cosmetic_overrides_name_ep_campaign_group_faction_cosmetics_prince_of_changle	Lady of Changle	false
campaign_group_faction_cosmetic_overrides_name_3k_main_campaign_group_cosmetic_tag_faction_name_xindu_separatists_3	Duchy of Xindu Separatists	false
campaign_group_faction_cosmetic_overrides_name_3k_main_campaign_group_cosmetic_tag_faction_name_liu_yu_3	Duchy of Daijun	false
campaign_group_faction_cosmetic_overrides_name_3k_main_campaign_group_cosmetic_tag_faction_name_zhang_yang_3	Duchy of Zhongshan	false
campaign_group_faction_cosmetic_overrides_name_3k_main_campaign_group_cosmetic_tag_faction_name_cao_separatists_world_leader	Kingdom of Wei Separatists	false
campaign_group_faction_cosmetic_overrides_name_3k_main_campaign_group_cosmetic_tag_faction_name_cangwu_separatists_3	Duchy of Cangwu Separatists	false
campaign_group_faction_cosmetic_overrides_name_3k_main_campaign_group_cosmetic_tag_faction_name_lady_diao_chan_hero_water	PH	false
campaign_group_faction_cosmetic_overrides_name_3k_dlc05_campaign_group_cosmetic_tag_faction_name_shi_huang_3	Duchy of Cangwu	false
campaign_group_faction_cosmetic_overrides_name_ep_campaign_group_faction_cosmetics_prince_of_pencheng	Lady of Pengcheng	false
campaign_group_faction_cosmetic_overrides_name_3k_main_campaign_group_cosmetic_tag_faction_name_han_sui_separatists_world_leader	Kingdom of Zhai Separatists	false
campaign_group_faction_cosmetic_overrides_name_3k_main_campaign_group_cosmetic_tag_faction_name_wuwei_3	Duchy of Wuwei	false
campaign_group_faction_cosmetic_overrides_name_3k_main_campaign_group_cosmetic_tag_faction_name_youbeiping_separatists_4	Kingdom of Youbeiping Separatists	false
campaign_group_faction_cosmetic_overrides_name_ep_campaign_group_faction_cosmetics_prince_of_badong	Lady of Badong	false
campaign_group_faction_cosmetic_overrides_name_3k_main_campaign_group_cosmetic_tag_faction_name_wang_kuang_separatists_world_leader	Kingdom of Wang Separatists	false
campaign_group_faction_cosmetic_overrides_name_3k_dlc04_campaign_group_cosmetic_tag_faction_name_chen_gui_4	Kingdom of Qing	false
campaign_group_faction_cosmetic_overrides_name_3k_main_campaign_group_cosmetic_tag_faction_name_jianning_separatists_world_leader	Kingdom of Jianning Separatists	false
campaign_group_faction_cosmetic_overrides_name_3k_main_campaign_group_cosmetic_tag_faction_name_hedong_4	Kingdom of Hedong	false
campaign_group_faction_cosmetic_overrides_name_3k_main_campaign_group_cosmetic_tag_faction_name_chen_separatists_world_leader	Kingdom of Chenjun Separatists	false
campaign_group_faction_cosmetic_overrides_name_ep_campaign_group_faction_cosmetics_prince_of_chenliu	Lady of Chenliu	false
campaign_group_faction_cosmetic_overrides_name_3k_main_campaign_group_cosmetic_tag_faction_name_zhongshan_separatists_3	Duchy of Shang Separatists	false
campaign_group_faction_cosmetic_overrides_name_3k_dlc04_campaign_group_cosmetic_tag_faction_name_cao_song_3	Duchy of Yang	false
campaign_group_faction_cosmetic_overrides_name_3k_dlc04_campaign_group_cosmetic_tag_faction_name_chu_gong_separatists_world_leader	Kingdom of Sili Separatists	false
campaign_group_faction_cosmetic_overrides_name_3k_dlc04_campaign_group_cosmetic_tag_faction_name_wang_rui_4	Kingdom of Xu	false
campaign_group_faction_cosmetic_overrides_name_3k_main_campaign_group_cosmetic_tag_faction_name_jiangyang_world_leader	Kingdom of Jiangyang	false
campaign_group_faction_cosmetic_overrides_name_3k_main_campaign_group_cosmetic_tag_faction_name_ba_separatists_3	Duchy of Ba Separatists	false
campaign_group_faction_cosmetic_overrides_name_3k_main_campaign_group_cosmetic_tag_faction_name_ye_world_leader	Kingdom of Ye	false
campaign_group_faction_cosmetic_overrides_name_3k_main_campaign_group_cosmetic_tag_faction_name_liu_dai_separatists_3	Duchy of Tang Separatists	false
campaign_group_faction_cosmetic_overrides_name_ep_campaign_group_faction_cosmetics_prince_of_lujiang_separatists	Lady of Lujiang Separatists	false
campaign_group_faction_cosmetic_overrides_name_3k_main_campaign_group_cosmetic_tag_faction_name_hanzhong_separatists_4	Kingdom of Hanzhong Separatists	false
campaign_group_faction_cosmetic_overrides_name_3k_main_campaign_group_cosmetic_tag_faction_name_yingchuan_separatists_4	Kingdom of Yingchuan Separatists	false
campaign_group_faction_cosmetic_overrides_name_3k_main_campaign_group_cosmetic_tag_faction_name_sun_jian_world_leader	Kingdom of Wu	false
campaign_group_faction_cosmetic_overrides_name_3k_dlc04_campaign_group_cosmetic_tag_faction_name_lu_zhi_world_leader	Kingdom of Guangyang	false
campaign_group_faction_cosmetic_overrides_name_3k_main_campaign_group_cosmetic_tag_faction_name_zhongshan_3	Duchy of Shang	false
campaign_group_faction_cosmetic_overrides_name_3k_main_campaign_group_cosmetic_tag_faction_name_hanzhong_3	Duchy of Hanzhong	false
campaign_group_faction_cosmetic_overrides_name_3k_dlc04_campaign_group_cosmetic_tag_faction_name_xin_xuan_separatists_4	Kingdom of Jing Separatists	false
campaign_group_faction_cosmetic_overrides_name_3k_main_campaign_group_cosmetic_tag_faction_name_han_sui_world_leader	Kingdom of Zhai	false
campaign_group_faction_cosmetic_overrides_name_3k_main_campaign_group_cosmetic_tag_faction_name_yanmen_4	Kingdom of Yanmen	false
campaign_group_faction_cosmetic_overrides_name_3k_main_campaign_group_cosmetic_tag_faction_name_zhang_yan_separatists_world_leader	Kingdom of Heishan Separatists	false
campaign_group_faction_cosmetic_overrides_name_ep_campaign_group_faction_cosmetics_prince_of_rencheng_separatists	Lady of Rencheng Separatists	false
campaign_group_faction_cosmetic_overrides_name_3k_main_campaign_group_cosmetic_tag_faction_name_changan_separatists_world_leader	Kingdom of Jingzhao Separatists	false
campaign_group_faction_cosmetic_overrides_name_3k_main_campaign_group_cosmetic_tag_faction_name_jiaozhi_separatists_world_leader	Kingdom of Jiaozhi Separatists	false
campaign_group_faction_cosmetic_overrides_name_3k_main_campaign_group_cosmetic_tag_faction_name_pingyuan_4	Kingdom of Pingyuan	false
campaign_group_faction_cosmetic_overrides_name_3k_main_campaign_group_cosmetic_tag_faction_name_yizhou_3	Duchy of Yizhou	false
campaign_group_faction_cosmetic_overrides_name_3k_main_campaign_group_cosmetic_tag_faction_name_jiangxia_separatists_4	Kingdom of Jiangxia Separatists	false
campaign_group_faction_cosmetic_overrides_name_3k_main_campaign_group_cosmetic_tag_faction_name_zhang_lu_world_leader	Kingdom of Hanning	false
campaign_group_faction_cosmetic_overrides_name_3k_main_campaign_group_cosmetic_tag_faction_name_ba_4	Kingdom of Ba	false
campaign_group_faction_cosmetic_overrides_name_3k_main_campaign_group_cosmetic_tag_faction_name_yanmen_separatists_3	Duchy of Yanmen Separatists	false
campaign_group_faction_cosmetic_overrides_name_ep_campaign_group_faction_cosmetics_prince_of_chenliu_separatists	Lady of Chenliu Separatists	false
campaign_group_faction_cosmetic_overrides_name_3k_main_campaign_group_cosmetic_tag_faction_name_fuling_separatists_3	Duchy of Fuling Separatists	false
campaign_group_faction_cosmetic_overrides_name_3k_main_campaign_group_cosmetic_tag_faction_name_shi_separatists_4	Kingdom of Jiuzhen Separatists	false
campaign_group_faction_cosmetic_overrides_name_ep_campaign_group_faction_cosmetics_prince_of_shunyang_separatists	Lady of Shunyang Separatists	false
campaign_group_faction_cosmetic_overrides_name_3k_main_campaign_group_cosmetic_tag_faction_name_luoyang_4	Kingdom of Luoyang	false
campaign_group_faction_cosmetic_overrides_name_3k_main_campaign_group_cosmetic_tag_faction_name_luoyang_3	Duchy of Luoyang	false
campaign_group_faction_cosmetic_overrides_name_3k_dlc04_campaign_group_cosmetic_tag_faction_name_dong_he_4	Kingdom of Yi	false
campaign_group_faction_cosmetic_overrides_name_ep_campaign_group_faction_cosmetics_prince_of_jiangxia_separatists	Lady of Jiangxia Separatists	false
campaign_group_faction_cosmetic_overrides_name_3k_dlc05_campaign_group_cosmetic_tag_faction_name_white_tiger_yan_separatists_3	Duchy of Yue Separatists	false
campaign_group_faction_cosmetic_overrides_name_3k_main_campaign_group_cosmetic_tag_faction_name_changan_4	Kingdom of Jingzhao	false
campaign_group_faction_cosmetic_overrides_name_3k_main_campaign_group_cosmetic_tag_faction_name_liaodong_separatists_world_leader	Kingdom of Liaodong Separatists	false
campaign_group_faction_cosmetic_overrides_name_3k_main_campaign_group_cosmetic_tag_faction_name_anding_3	Duchy of Anding	false
campaign_group_faction_cosmetic_overrides_name_3k_main_campaign_group_cosmetic_tag_faction_name_badong_4	Kingdom of Badong	false
campaign_group_faction_cosmetic_overrides_name_3k_main_campaign_group_cosmetic_tag_faction_name_fuling_separatists_4	Kingdom of Fuling Separatists	false
campaign_group_faction_cosmetic_overrides_name_3k_main_campaign_group_cosmetic_tag_faction_name_wuling_separatists_4	Kingdom of Wuling Separatists	false
campaign_group_faction_cosmetic_overrides_name_3k_main_campaign_group_cosmetic_tag_faction_name_wuwei_separatists_3	Duchy of Wuwei Separatists	false
campaign_group_faction_cosmetic_overrides_name_3k_dlc04_campaign_group_cosmetic_tag_faction_name_lu_zhi_4	Kingdom of Guangyang	false
campaign_group_faction_cosmetic_overrides_name_ep_campaign_group_faction_cosmetics_prince_of_nanhai_separatists	Lady of Nanhai Separatists	false
campaign_group_faction_cosmetic_overrides_name_ep_campaign_group_faction_cosmetics_prince_of_jiangyang_separatists	Lady of Jiangyang Separatists	false
campaign_group_faction_cosmetic_overrides_name_3k_main_campaign_group_cosmetic_tag_faction_name_zangke_separatists_4	Kingdom of Zangke Separatists	false
campaign_group_faction_cosmetic_overrides_name_3k_main_campaign_group_cosmetic_tag_faction_name_cai_mao_separatists_world_leader	Kingdom of Cai Separatists	false
campaign_group_faction_cosmetic_overrides_name_3k_main_campaign_group_cosmetic_tag_faction_name_changan_separatists_4	Kingdom of Jingzhao Separatists	false
campaign_group_faction_cosmetic_overrides_name_3k_main_campaign_group_cosmetic_tag_faction_name_liu_yao_separatists_3	Duchy of Yue Separatists	false
campaign_group_faction_cosmetic_overrides_name_3k_dlc05_campaign_group_cosmetic_tag_faction_name_xue_li_separatists_world_leader	Kingdom of Zhongli Separatists	false
campaign_group_faction_cosmetic_overrides_name_3k_main_campaign_group_cosmetic_tag_faction_name_badong_3	Duchy of Badong	false
campaign_group_faction_cosmetic_overrides_name_3k_main_campaign_group_cosmetic_tag_faction_name_shi_separatists_3	Duchy of Jiuzhen Separatists	false
campaign_group_faction_cosmetic_overrides_name_3k_main_campaign_group_cosmetic_tag_faction_name_yizhou_separatists_4	Kingdom of Yizhou Separatists	false
campaign_group_faction_cosmetic_overrides_name_3k_main_campaign_group_cosmetic_tag_faction_name_shoufang_separatists_world_leader	Kingdom of Shuofang Separatists	false
campaign_group_faction_cosmetic_overrides_name_3k_dlc05_campaign_group_cosmetic_tag_faction_name_hua_xin_separatists_world_leader	Kingdom of Huainan Separatists	false
campaign_group_faction_cosmetic_overrides_name_3k_main_campaign_group_cosmetic_tag_faction_name_henei_separatists_3	Duchy of Henei Separatists	false
campaign_group_faction_cosmetic_overrides_name_3k_main_campaign_group_cosmetic_tag_faction_name_yizhou_separatists_world_leader	Kingdom of Yizhou Separatists	false
campaign_group_faction_cosmetic_overrides_name_3k_main_campaign_group_cosmetic_tag_faction_name_cao_cao_hero_earth	PH	false
campaign_group_faction_cosmetic_overrides_name_3k_main_campaign_group_cosmetic_tag_faction_name_langye_separatists_3	Duchy of Langye Separatists	false
campaign_group_faction_cosmetic_overrides_name_ep_campaign_group_faction_cosmetics_prince_of_gaoliang_separatists	Lady of Gaoliang Separatists	false
campaign_group_faction_cosmetic_overrides_name_3k_main_campaign_group_cosmetic_tag_faction_name_dong_zhuo_world_leader	Kingdom of Zhou	false
campaign_group_faction_cosmetic_overrides_name_3k_main_campaign_group_cosmetic_tag_faction_name_cangwu_separatists_world_leader	Kingdom of Cangwu Separatists	false
campaign_group_faction_cosmetic_overrides_name_3k_dlc07_campaign_group_cosmetic_tag_faction_name_han_empire	Han Empire	false
campaign_group_faction_cosmetic_overrides_name_3k_main_campaign_group_cosmetic_tag_faction_name_langye_separatists_4	Kingdom of Langye Separatists	false
campaign_group_faction_cosmetic_overrides_name_3k_main_campaign_group_cosmetic_tag_faction_name_taishan_4	Kingdom of Lean	false
campaign_group_faction_cosmetic_overrides_name_3k_main_campaign_group_cosmetic_tag_faction_name_xiahou_yuan_hero_fire	PH	false
campaign_group_faction_cosmetic_overrides_name_3k_main_campaign_group_cosmetic_tag_faction_name_jiaozhi_3	Duchy of Jiaozhi	false
campaign_group_faction_cosmetic_overrides_name_3k_main_campaign_group_cosmetic_tag_faction_name_xihe_separatists_3	Duchy of Xihe Separatists	false
campaign_group_faction_cosmetic_overrides_name_3k_dlc04_campaign_group_cosmetic_tag_faction_name_liu_hong_separatists_4	Kingdom of Nan Separatists	false
campaign_group_faction_cosmetic_overrides_name_3k_main_campaign_group_cosmetic_tag_faction_name_yuan_separatists_4	Kingdom of Song Separatists	false
campaign_group_faction_cosmetic_overrides_name_3k_dlc05_campaign_group_cosmetic_tag_faction_name_lu_bu_separatists_3	Duchy of Yin Separatists	false
campaign_group_faction_cosmetic_overrides_name_3k_main_campaign_group_cosmetic_tag_faction_name_hanzhong_separatists_3	Duchy of Hanzhong Separatists	false
campaign_group_faction_cosmetic_overrides_name_ep_campaign_group_faction_cosmetics_prince_of_xindu_separatists	Lady of Xindu Separatists	false
campaign_group_faction_cosmetic_overrides_name_3k_dlc05_campaign_group_cosmetic_tag_faction_name_wu_jing_separatists_world_leader	Kingdom of Xu Separatists	false
campaign_group_faction_cosmetic_overrides_name_ep_campaign_group_faction_cosmetics_prince_of_pencheng_separatists	Lady of Pengcheng Separatists	false
campaign_group_faction_cosmetic_overrides_name_3k_main_campaign_group_cosmetic_tag_faction_name_baxi_4	Kingdom of Baxi	false
campaign_group_faction_cosmetic_overrides_name_3k_main_campaign_group_cosmetic_tag_faction_name_anping_separatists_3	Duchy of Anping Separatists	false
campaign_group_faction_cosmetic_overrides_name_3k_dlc04_campaign_group_cosmetic_tag_faction_name_lu_zhi_separatists_3	Duchy of Guangyang Separatists	false
campaign_group_faction_cosmetic_overrides_name_3k_main_campaign_group_cosmetic_tag_faction_name_shangyong_separatists_4	Kingdom of Shangyong Separatists	false
campaign_group_faction_cosmetic_overrides_name_3k_main_campaign_group_cosmetic_tag_faction_name_nanhai_separatists_world_leader	Kingdom of Nanhai Separatists	false
campaign_group_faction_cosmetic_overrides_name_3k_main_campaign_group_cosmetic_tag_faction_name_han_sui_4	Kingdom of Zhai	false
campaign_group_faction_cosmetic_overrides_name_3k_main_campaign_group_cosmetic_tag_faction_name_henei_4	Kingdom of Henei	false
campaign_group_faction_cosmetic_overrides_name_3k_dlc05_campaign_group_cosmetic_tag_faction_name_yuan_tan_world_leader	Kingdom of Nie	false
campaign_group_faction_cosmetic_overrides_name_ep_campaign_group_faction_cosmetics_prince_of_taiyuan_separatists	Lady of Taiyuan Separatists	false
campaign_group_faction_cosmetic_overrides_name_ep_campaign_group_faction_cosmetics_prince_of_jiaozhi_separatists	Lady of Jiaozhi Separatists	false
campaign_group_faction_cosmetic_overrides_name_3k_main_campaign_group_cosmetic_tag_faction_name_wudu_4	Kingdom of Wudu	false
campaign_group_faction_cosmetic_overrides_name_3k_dlc04_campaign_group_cosmetic_tag_faction_name_yuan_yi_separatists_world_leader	Kingdom of Pei Separatists	false
campaign_group_faction_cosmetic_overrides_name_3k_dlc05_campaign_group_cosmetic_tag_faction_name_xu_gong_3	Duchy of Chao	false
campaign_group_faction_cosmetic_overrides_name_3k_main_campaign_group_cosmetic_tag_faction_name_wuling_4	Kingdom of Wuling	false
campaign_group_faction_cosmetic_overrides_name_3k_main_campaign_group_cosmetic_tag_faction_name_gao_gan_separatists_4	Kingdom of Bing Separatists	false
campaign_group_faction_cosmetic_overrides_name_3k_dlc05_campaign_group_cosmetic_tag_faction_name_xue_li_separatists_3	Duchy of Zhongli Separatists	false
campaign_group_faction_cosmetic_overrides_name_3k_main_campaign_group_cosmetic_tag_faction_name_taishan_separatists_world_leader	Kingdom of Lean Separatists	false
campaign_group_faction_cosmetic_overrides_name_ep_campaign_group_faction_cosmetics_prince_of_wu	Lady of Wu	false
campaign_group_faction_cosmetic_overrides_name_3k_main_campaign_group_cosmetic_tag_faction_name_nanyang_3	Duchy of Nanyang	false
campaign_group_faction_cosmetic_overrides_name_3k_main_campaign_group_cosmetic_tag_faction_name_wudu_3	Duchy of Wudu	false
campaign_group_faction_cosmetic_overrides_name_3k_dlc05_campaign_group_cosmetic_tag_faction_name_sun_ce_separatists_4		false
campaign_group_faction_cosmetic_overrides_name_3k_main_campaign_group_cosmetic_tag_faction_name_dongou_separatists_4	Kingdom of Linhai Separatists	false
campaign_group_faction_cosmetic_overrides_name_ep_campaign_group_faction_cosmetics_prince_of_beihai	Lady of Beihai	false
campaign_group_faction_cosmetic_overrides_name_ep_campaign_group_faction_cosmetics_prince_of_zhangwu_separatists	Lady of Zhangwu Separatists	false
campaign_group_faction_cosmetic_overrides_name_3k_main_campaign_group_cosmetic_tag_faction_name_jianning_world_leader	Kingdom of Jianning	false
campaign_group_faction_cosmetic_overrides_name_3k_main_campaign_group_cosmetic_tag_faction_name_wuling_separatists_3	Duchy of Wuling Separatists	false
campaign_group_faction_cosmetic_overrides_name_3k_main_campaign_group_cosmetic_tag_faction_name_jianye_separatists_4	Kingdom of Danyang Separatists	false
campaign_group_faction_cosmetic_overrides_name_3k_main_campaign_group_cosmetic_tag_faction_name_luling_separatists_3	Duchy of Luling Separatists	false
campaign_group_faction_cosmetic_overrides_name_3k_dlc05_campaign_group_cosmetic_tag_faction_name_tian_kai_4	Kingdom of Zhao	false
campaign_group_faction_cosmetic_overrides_name_3k_main_campaign_group_cosmetic_tag_faction_name_cao_cao_4	Kingdom of Wei	false
campaign_group_faction_cosmetic_overrides_name_3k_dlc04_campaign_group_cosmetic_tag_faction_name_ying_shao_world_leader	Kingdom of Xiapi	false
campaign_group_faction_cosmetic_overrides_name_ep_campaign_group_faction_cosmetics_prince_of_qiao	Lady of Qiao	false
campaign_group_faction_cosmetic_overrides_name_3k_dlc04_campaign_group_cosmetic_tag_faction_name_prince_liu_chong_3	Duchy of Chen	false
campaign_group_faction_cosmetic_overrides_name_3k_dlc04_campaign_group_cosmetic_tag_faction_name_cao_song_separatists_world_leader	Kingdom of Yang Separatists	false
campaign_group_faction_cosmetic_overrides_name_ep_campaign_group_faction_cosmetics_prince_of_changan	Lady of Chang’an	false
campaign_group_faction_cosmetic_overrides_name_ep_campaign_group_faction_cosmetics_prince_of_yangzhou	Lady of Yangzhou	false
campaign_group_faction_cosmetic_overrides_name_3k_dlc04_campaign_group_cosmetic_tag_faction_name_qiao_mao_world_leader	Kingdom of Dong	false
campaign_group_faction_cosmetic_overrides_name_3k_main_campaign_group_cosmetic_tag_faction_name_poyang_3	Duchy of Poyang	false
campaign_group_faction_cosmetic_overrides_name_3k_main_campaign_group_cosmetic_tag_faction_name_zhang_lu_3	Duchy of Hanning	false
campaign_group_faction_cosmetic_overrides_name_3k_main_campaign_group_cosmetic_tag_faction_name_ba_3	Duchy of Ba	false
campaign_group_faction_cosmetic_overrides_name_3k_main_campaign_group_cosmetic_tag_faction_name_nanhai_separatists_3	Duchy of Nanhai Separatists	false
campaign_group_faction_cosmetic_overrides_name_3k_main_campaign_group_cosmetic_tag_faction_name_ye_separatists_4	Kingdom of Ye Separatists	false
campaign_group_faction_cosmetic_overrides_name_3k_main_campaign_group_cosmetic_tag_faction_name_anping_3	Duchy of Anping	false
campaign_group_faction_cosmetic_overrides_name_3k_main_campaign_group_cosmetic_tag_faction_name_chen_4	Kingdom of Chenjun	false
campaign_group_faction_cosmetic_overrides_name_ep_campaign_group_faction_cosmetics_prince_of_lean	Lady of Lean	false
campaign_group_faction_cosmetic_overrides_name_ep_campaign_group_faction_cosmetics_prince_of_dongping_separatists	Lady of Dongping Separatists	false
campaign_group_faction_cosmetic_overrides_name_ep_campaign_group_faction_cosmetics_prince_of_runan	Lady of Ru'nan	false
campaign_group_faction_cosmetic_overrides_name_3k_dlc05_campaign_group_cosmetic_tag_faction_name_sun_ce_3	Duchy of Wu	false
campaign_group_faction_cosmetic_overrides_name_3k_main_campaign_group_cosmetic_tag_faction_name_huang_zu_separatists_4	Kingdom of Sui Separatists	false
campaign_group_faction_cosmetic_overrides_name_3k_main_campaign_group_cosmetic_tag_faction_name_jia_long_separatists_4	Kingdom of Jianwei Separatists	false
campaign_group_faction_cosmetic_overrides_name_ep_campaign_group_faction_cosmetics_prince_of_poyang_separatists	Lady of Poyang Separatists	false
campaign_group_faction_cosmetic_overrides_name_3k_dlc04_campaign_group_cosmetic_tag_faction_name_liu_xun_4	Kingdom of Chengyang	false
campaign_group_faction_cosmetic_overrides_name_3k_main_campaign_group_cosmetic_tag_faction_name_zheng_jiang_separatists_4	Tai Dominion Separatists	false
campaign_group_faction_cosmetic_overrides_name_3k_main_campaign_group_cosmetic_tag_faction_name_xiangyang_4	Kingdom of Xiangyang	false
campaign_group_faction_cosmetic_overrides_name_3k_dlc04_campaign_group_cosmetic_tag_faction_name_qiao_mao_separatists_4	Kingdom of Dong Separatists	false
campaign_group_faction_cosmetic_overrides_name_3k_main_campaign_group_cosmetic_tag_faction_name_ma_teng_3	Duchy of Liang	false
campaign_group_faction_cosmetic_overrides_name_3k_main_campaign_group_cosmetic_tag_faction_name_liu_bei_separatists_3	Duchy of Shu-Han Separatists	false
campaign_group_faction_cosmetic_overrides_name_3k_dlc04_campaign_group_cosmetic_tag_faction_name_liu_hong_separatists_world_leader	Kingdom of Nan Separatists	false
campaign_group_faction_cosmetic_overrides_name_3k_main_campaign_group_cosmetic_tag_faction_name_lingling_3	Duchy of Lingling	false
campaign_group_faction_cosmetic_overrides_name_3k_main_campaign_group_cosmetic_tag_faction_name_yuan_separatists_world_leader	Kingdom of Song Separatists	false
campaign_group_faction_cosmetic_overrides_name_3k_main_campaign_group_cosmetic_tag_faction_name_gaoliang_3	Duchy of Gaoliang	false
campaign_group_faction_cosmetic_overrides_name_3k_main_campaign_group_cosmetic_tag_faction_name_badong_separatists_3	Duchy of Badong Separatists	false
campaign_group_faction_cosmetic_overrides_name_3k_main_campaign_group_cosmetic_tag_faction_name_cai_mao_world_leader	Kingdom of Cai	false
campaign_group_faction_cosmetic_overrides_name_3k_main_campaign_group_cosmetic_tag_faction_name_anping_separatists_world_leader	Kingdom of Anping Separatists	false
campaign_group_faction_cosmetic_overrides_name_3k_main_campaign_group_cosmetic_tag_faction_name_xihe_4	Kingdom of Xihe	false
campaign_group_faction_cosmetic_overrides_name_3k_dlc04_campaign_group_cosmetic_tag_faction_name_wang_rui_separatists_3	Duchy of Xu Separatists	false
campaign_group_faction_cosmetic_overrides_name_3k_main_campaign_group_cosmetic_tag_faction_name_tong'an_world_leader	Kingdom of Tong'an	false
campaign_group_faction_cosmetic_overrides_name_3k_main_campaign_group_cosmetic_tag_faction_name_jincheng_separatists_3	Duchy of Jincheng Separatists	false
campaign_group_faction_cosmetic_overrides_name_3k_dlc04_campaign_group_cosmetic_tag_faction_name_yuan_yi_separatists_4	Kingdom of Pei Separatists	false
campaign_group_faction_cosmetic_overrides_name_3k_main_campaign_group_cosmetic_tag_faction_name_hedong_separatists_3	Duchy of Hedong Separatists	false
campaign_group_faction_cosmetic_overrides_name_3k_main_campaign_group_cosmetic_tag_faction_name_yangzhou_4	Kingdom of Huainan	false
campaign_group_faction_cosmetic_overrides_name_3k_main_campaign_group_cosmetic_tag_faction_name_liu_bei_world_leader	Kingdom of Shu-Han	false
campaign_group_faction_cosmetic_overrides_name_3k_main_campaign_group_cosmetic_tag_faction_name_cai_mao_separatists_4	Kingdom of Cai Separatists	false
campaign_group_faction_cosmetic_overrides_name_3k_main_campaign_group_cosmetic_tag_faction_name_jia_long_world_leader	Kingdom of Jianwei	false
campaign_group_faction_cosmetic_overrides_name_ep_campaign_group_faction_cosmetics_prince_of_yanmen	Lady of Yanmen	false
campaign_group_faction_cosmetic_overrides_name_3k_main_campaign_group_cosmetic_tag_faction_name_gongsun_zan_4	Kingdom of Yan	false
campaign_group_faction_cosmetic_overrides_name_3k_main_campaign_group_cosmetic_tag_faction_name_liu_dai_3	Duchy of Tang	false
campaign_group_faction_cosmetic_overrides_name_ep_campaign_group_faction_cosmetics_prince_of_donglai_separatists	Lady of Donglai Separatists	false
campaign_group_faction_cosmetic_overrides_name_3k_dlc05_campaign_group_cosmetic_tag_faction_name_white_tiger_yan_4	Kingdom of Yue	false
campaign_group_faction_cosmetic_overrides_name_3k_dlc04_campaign_group_cosmetic_tag_faction_name_ding_yuan_separatists_world_leader	Kingdom of Bing Separatists	false
campaign_group_faction_cosmetic_overrides_name_ep_campaign_group_faction_cosmetics_prince_of_jiangling	Lady of Jiangling	false
campaign_group_faction_cosmetic_overrides_name_3k_main_campaign_group_cosmetic_tag_faction_name_anping_world_leader	Kingdom of Anping	false
campaign_group_faction_cosmetic_overrides_name_3k_dlc04_campaign_group_cosmetic_tag_faction_name_prince_liu_chong_separatists_world_leader	Kingdom of Chen Separatists	false
campaign_group_faction_cosmetic_overrides_name_3k_dlc05_campaign_group_cosmetic_tag_faction_name_wu_jing_world_leader	Kingdom of Xu	false
campaign_group_faction_cosmetic_overrides_name_3k_main_campaign_group_cosmetic_tag_faction_name_shoufang_4	Kingdom of Shuofang	false
campaign_group_faction_cosmetic_overrides_name_3k_main_campaign_group_cosmetic_tag_han_empire	Han Empire	false
campaign_group_faction_cosmetic_overrides_name_3k_dlc04_campaign_group_cosmetic_tag_faction_name_liu_xun_separatists_3	Duchy of Chengyang Separatists	false
campaign_group_faction_cosmetic_overrides_name_3k_main_campaign_group_cosmetic_tag_faction_name_cao_pi_hero_earth	PH	false
campaign_group_faction_cosmetic_overrides_name_3k_main_campaign_group_cosmetic_tag_faction_name_shangyong_3	Duchy of Shangyong	false
campaign_group_faction_cosmetic_overrides_name_ep_campaign_group_faction_cosmetics_prince_of_huainan	Lady of Huainan	false
campaign_group_faction_cosmetic_overrides_name_3k_main_campaign_group_cosmetic_tag_faction_name_anding_separatists_world_leader	Kingdom of Anding Separatists	false
campaign_group_faction_cosmetic_overrides_name_3k_main_campaign_group_cosmetic_tag_faction_name_zhang_chao_4	Kingdom of Zhongwu	false
campaign_group_faction_cosmetic_overrides_name_3k_dlc05_campaign_group_cosmetic_tag_faction_name_sun_ce_world_leader	Kingdom of Wu	false
campaign_group_faction_cosmetic_overrides_name_3k_dlc04_campaign_group_cosmetic_tag_faction_name_ding_yuan_3	Duchy of Bing	false
campaign_group_faction_cosmetic_overrides_name_3k_main_campaign_group_cosmetic_tag_faction_name_jianan_separatists_4	Kingdom of Jian'an Separatists	false
campaign_group_faction_cosmetic_overrides_name_3k_main_campaign_group_cosmetic_tag_faction_name_jincheng_3	Duchy of Jincheng	false
campaign_group_faction_cosmetic_overrides_name_ep_campaign_group_faction_cosmetics_prince_of_kuaiji	Lady of Kuaiji	false
campaign_group_faction_cosmetic_overrides_name_3k_main_campaign_group_cosmetic_tag_faction_name_youbeiping_4	Kingdom of Youbeiping	false
campaign_group_faction_cosmetic_overrides_name_3k_main_campaign_group_cosmetic_tag_faction_name_poyang_separatists_world_leader	Kingdom of Poyang Separatists	false
campaign_group_faction_cosmetic_overrides_name_3k_dlc04_campaign_group_cosmetic_tag_faction_name_ying_shao_separatists_3	Duchy of Xiapi Separatists	false
campaign_group_faction_cosmetic_overrides_name_ep_campaign_group_faction_cosmetics_prince_of_ye_separatists	Lady of Ye Separatists	false
campaign_group_faction_cosmetic_overrides_name_3k_main_campaign_group_cosmetic_tag_faction_name_wang_kuang_separatists_3	Duchy of Wang Separatists	false
campaign_group_faction_cosmetic_overrides_name_3k_dlc05_campaign_group_cosmetic_tag_faction_name_tian_kai_separatists_3	Duchy of Zhao Separatists	false
campaign_group_faction_cosmetic_overrides_name_3k_main_campaign_group_cosmetic_tag_faction_name_xiangyang_separatists_world_leader	Kingdom of Xiangyang Separatists	false
campaign_group_faction_cosmetic_overrides_name_3k_main_campaign_group_cosmetic_tag_faction_name_liu_yu_hero_earth	PH	false
campaign_group_faction_cosmetic_overrides_name_3k_main_campaign_group_cosmetic_tag_faction_name_yu_world_leader	Kingdom of Yu	false
campaign_group_faction_cosmetic_overrides_name_3k_main_campaign_group_cosmetic_tag_faction_name_henei_separatists_4	Kingdom of Henei Separatists	false
campaign_group_faction_cosmetic_overrides_name_ep_campaign_group_faction_cosmetics_prince_of_xihe_separatists	Lady of Xihe Separatists	false
campaign_group_faction_cosmetic_overrides_name_ep_campaign_group_faction_cosmetics_prince_of_lingling	Lady of Lingling	false
campaign_group_faction_cosmetic_overrides_name_3k_main_campaign_group_cosmetic_tag_faction_name_huang_zu_4	Kingdom of Sui	false
campaign_group_faction_cosmetic_overrides_name_3k_dlc04_campaign_group_cosmetic_tag_faction_name_cao_song_world_leader	Kingdom of Yang	false
campaign_group_faction_cosmetic_overrides_name_3k_main_campaign_group_cosmetic_tag_faction_name_lady_zheng_jiang_hero_wood	PH	false
campaign_group_faction_cosmetic_overrides_name_3k_dlc05_campaign_group_cosmetic_tag_faction_name_yang_feng_world_leader	Kingdom of Wey	false
campaign_group_faction_cosmetic_overrides_name_3k_main_campaign_group_cosmetic_tag_faction_name_zangke_world_leader	Kingdom of Zangke	false
campaign_group_faction_cosmetic_overrides_name_3k_main_campaign_group_cosmetic_tag_faction_name_tao_qian_world_leader	Kingdom of Lu	false
campaign_group_faction_cosmetic_overrides_name_3k_main_campaign_group_cosmetic_tag_faction_name_cangwu_4	Kingdom of Cangwu	false
campaign_group_faction_cosmetic_overrides_name_ep_campaign_group_faction_cosmetics_prince_of_yuzhang	Lady of Yuzhang	false
campaign_group_faction_cosmetic_overrides_name_ep_campaign_group_faction_cosmetics_prince_of_hejian_separatists	Lady of Hejian Separatists	false
campaign_group_faction_cosmetic_overrides_name_3k_main_campaign_group_cosmetic_tag_faction_name_dongjun_separatists_3	Duchy of Dongjun Separatists	false
campaign_group_faction_cosmetic_overrides_name_3k_main_campaign_group_cosmetic_tag_faction_name_anding_4	Kingdom of Anding	false
campaign_group_faction_cosmetic_overrides_name_3k_main_campaign_group_cosmetic_tag_faction_name_cao_cao_3	Duchy of Wei	false
campaign_group_faction_cosmetic_overrides_name_3k_main_campaign_group_cosmetic_tag_faction_name_yingchuan_separatists_3	Duchy of Yingchuan Separatists	false
campaign_group_faction_cosmetic_overrides_name_ep_campaign_group_faction_cosmetics_prince_of_dai	Lady of Dai	false
campaign_group_faction_cosmetic_overrides_name_3k_main_campaign_group_cosmetic_tag_faction_name_han_separatists_world_leader	Kingdom of Nie Separatists	false
campaign_group_faction_cosmetic_overrides_name_3k_main_campaign_group_cosmetic_tag_faction_name_xu_chu_hero_wood	PH	false
campaign_group_faction_cosmetic_overrides_name_3k_main_campaign_group_cosmetic_tag_faction_name_sun_separatists_world_leader	Kingdom of Wu Separatists	false
campaign_group_faction_cosmetic_overrides_name_3k_main_campaign_group_cosmetic_tag_faction_name_weijun_world_leader	Kingdom of Weijun	false
campaign_group_faction_cosmetic_overrides_name_3k_main_campaign_group_cosmetic_tag_faction_name_gongsun_zan_world_leader	Kingdom of Yan	false
campaign_group_faction_cosmetic_overrides_name_3k_dlc05_campaign_group_cosmetic_tag_faction_name_shi_huang_separatists_4	Kingdom of Cangwu Separatists	false
campaign_group_faction_cosmetic_overrides_name_3k_dlc05_campaign_group_cosmetic_tag_faction_name_yuan_tan_separatists_4	Kingdom of Nie Separatists	false
campaign_group_faction_cosmetic_overrides_name_3k_main_campaign_group_cosmetic_tag_faction_name_chen_world_leader	Kingdom of Chenjun	false
campaign_group_faction_cosmetic_overrides_name_3k_main_campaign_group_cosmetic_tag_faction_name_xiangyang_3	Duchy of Xiangyang	false
campaign_group_faction_cosmetic_overrides_name_3k_dlc04_campaign_group_cosmetic_tag_faction_name_prince_liu_chong_world_leader	Kingdom of Chen	false
campaign_group_faction_cosmetic_overrides_name_3k_main_campaign_group_cosmetic_tag_faction_name_chengdu_separatists_4	Kingdom of Shu Separatists	false
campaign_group_faction_cosmetic_overrides_name_3k_main_campaign_group_cosmetic_tag_faction_name_shangdang_separatists_4	Kingdom of Shangdang Separatists	false
campaign_group_faction_cosmetic_overrides_name_3k_main_campaign_group_cosmetic_tag_faction_name_sun_separatists_3	Duchy of Wu Separatists	false
campaign_group_faction_cosmetic_overrides_name_3k_main_campaign_group_cosmetic_tag_faction_name_wang_kuang_4	Kingdom of Wang	false
campaign_group_faction_cosmetic_overrides_name_3k_main_campaign_group_cosmetic_tag_faction_name_shangdang_separatists_world_leader	Kingdom of Shangdang Separatists	false
campaign_group_faction_cosmetic_overrides_name_3k_main_campaign_group_cosmetic_tag_faction_name_cao_separatists_4	Kingdom of Wei Separatists	false
campaign_group_faction_cosmetic_overrides_name_3k_dlc05_campaign_group_cosmetic_tag_faction_name_wu_jing_separatists_4	Kingdom of Xu Separatists	false
campaign_group_faction_cosmetic_overrides_name_3k_dlc05_campaign_group_cosmetic_tag_faction_name_zhu_fu_4	Kingdom of Kui	false
campaign_group_faction_cosmetic_overrides_name_3k_dlc05_campaign_group_cosmetic_tag_faction_name_xu_zhao_4	Kingdom of Wu	false
campaign_group_faction_cosmetic_overrides_name_ep_campaign_group_faction_cosmetics_prince_of_lujiang	Lady of Lujiang	false
campaign_group_faction_cosmetic_overrides_name_3k_main_campaign_group_cosmetic_tag_faction_name_zhang_lu_4	Kingdom of Hanning	false
campaign_group_faction_cosmetic_overrides_name_3k_main_campaign_group_cosmetic_tag_faction_name_taiyuan_3	Duchy of Taiyuan	false
campaign_group_faction_cosmetic_overrides_name_3k_main_campaign_group_cosmetic_tag_faction_name_xihe_world_leader	Kingdom of Xihe	false
campaign_group_faction_cosmetic_overrides_name_3k_main_campaign_group_cosmetic_tag_faction_name_jianan_separatists_world_leader	Kingdom of Jian'an Separatists	false
campaign_group_faction_cosmetic_overrides_name_3k_main_campaign_group_cosmetic_tag_faction_name_dong_zhuo_3	Duchy of Zhou	false
campaign_group_faction_cosmetic_overrides_name_3k_main_campaign_group_cosmetic_tag_faction_name_gongsun_du_hero_metal	PH	false
campaign_group_faction_cosmetic_overrides_name_3k_main_campaign_group_cosmetic_tag_faction_name_yulin_separatists_3	Duchy of Yulin Separatists	false
campaign_group_faction_cosmetic_overrides_name_3k_main_campaign_group_cosmetic_tag_faction_name_gaoliang_world_leader	Kingdom of Gaoliang	false
campaign_group_faction_cosmetic_overrides_name_3k_dlc04_campaign_group_cosmetic_tag_faction_name_xin_xuan_separatists_3	Duchy of Jing Separatists	false
campaign_group_faction_cosmetic_overrides_name_3k_dlc04_campaign_group_cosmetic_tag_faction_name_ying_shao_separatists_world_leader	Kingdom of Xiapi Separatists	false
campaign_group_faction_cosmetic_overrides_name_3k_main_campaign_group_cosmetic_tag_faction_name_taiyuan_4	Kingdom of Taiyuan	false
campaign_group_faction_cosmetic_overrides_name_3k_main_campaign_group_cosmetic_tag_faction_name_shoufang_separatists_3	Duchy of Shuofang Separatists	false
campaign_group_faction_cosmetic_overrides_name_3k_dlc04_campaign_group_cosmetic_tag_faction_name_chu_gong_world_leader	Kingdom of Sili	false
campaign_group_faction_cosmetic_overrides_name_3k_main_campaign_group_cosmetic_tag_faction_name_liu_yan_separatists_world_leader	Kingdom of Xun Separatists	false
campaign_group_faction_cosmetic_overrides_name_3k_dlc04_campaign_group_cosmetic_tag_faction_name_bian_zhang_separatists_4	Kingdom of Zhang Separatists	false
campaign_group_faction_cosmetic_overrides_name_ep_campaign_group_faction_cosmetics_prince_of_jincheng_separatists	Lady of Jincheng Separatists	false
campaign_group_faction_cosmetic_overrides_name_3k_main_campaign_group_cosmetic_tag_faction_name_hepu_3	Duchy of Hepu	false
campaign_group_faction_cosmetic_overrides_name_3k_dlc04_campaign_group_cosmetic_tag_faction_name_prince_liu_chong_4	Kingdom of Chen	false
campaign_group_faction_cosmetic_overrides_name_ep_campaign_group_faction_cosmetics_prince_of_nanyang	Lady of Nanyang	false
campaign_group_faction_cosmetic_overrides_name_3k_main_campaign_group_cosmetic_tag_faction_name_langye_4	Kingdom of Langye	false
campaign_group_faction_cosmetic_overrides_name_3k_main_campaign_group_cosmetic_tag_faction_name_yangzhou_3	Duchy of Huainan	false
campaign_group_faction_cosmetic_overrides_name_3k_main_campaign_group_cosmetic_tag_faction_name_liu_yu_4	Kingdom of Daijun	false
campaign_group_faction_cosmetic_overrides_name_3k_dlc05_campaign_group_cosmetic_tag_faction_name_lu_bu_separatists_world_leader	Kingdom of Yin Separatists	false
campaign_group_faction_cosmetic_overrides_name_3k_main_campaign_group_cosmetic_tag_faction_name_taishi_ci_hero_metal	PH	false
campaign_group_faction_cosmetic_overrides_name_ep_campaign_group_faction_cosmetics_prince_of_langye_separatists	Lady of Langye Separatists	false
campaign_group_faction_cosmetic_overrides_name_3k_main_campaign_group_cosmetic_tag_faction_name_dong_separatists_4	Kingdom of Zhou Separatists	false
campaign_group_faction_cosmetic_overrides_name_ep_campaign_group_faction_cosmetics_prince_of_fuling	Lady of Fuling	false
campaign_group_faction_cosmetic_overrides_name_3k_main_campaign_group_cosmetic_tag_faction_name_yingchuan_separatists_world_leader	Kingdom of Yingchuan Separatists	false
campaign_group_faction_cosmetic_overrides_name_3k_main_campaign_group_cosmetic_tag_faction_name_huang_zu_3	Duchy of Sui	false
campaign_group_faction_cosmetic_overrides_name_3k_main_campaign_group_cosmetic_tag_faction_name_liu_biao_separatists_world_leader	Kingdom of Chu Separatists	false
campaign_group_faction_cosmetic_overrides_name_3k_main_campaign_group_cosmetic_tag_faction_name_youzhou_world_leader	Kingdom of Guangyang	false
campaign_group_faction_cosmetic_overrides_name_3k_main_campaign_group_cosmetic_tag_faction_name_wang_lang_3	Duchy of Tan	false
campaign_group_faction_cosmetic_overrides_name_ep_campaign_group_faction_cosmetics_prince_of_lean_separatists	Lady of Lean Separatists	false
campaign_group_faction_cosmetic_overrides_name_ep_campaign_group_faction_cosmetics_prince_of_hepu_separatists	Lady of Hepu Separatists	false
campaign_group_faction_cosmetic_overrides_name_3k_main_campaign_group_cosmetic_tag_faction_name_gaoliang_4	Kingdom of Gaoliang	false
campaign_group_faction_cosmetic_overrides_name_ep_campaign_group_faction_cosmetics_prince_of_dongan	Lady of Dongan	false
campaign_group_faction_cosmetic_overrides_name_3k_main_campaign_group_cosmetic_tag_faction_name_taiyuan_separatists_3	Duchy of Taiyuan Separatists	false
campaign_group_faction_cosmetic_overrides_name_3k_main_campaign_group_cosmetic_tag_faction_name_liu_yan_separatists_3	Duchy of Xun Separatists	false
campaign_group_faction_cosmetic_overrides_name_3k_main_campaign_group_cosmetic_tag_faction_name_guan_yu_hero_wood	PH	false
campaign_group_faction_cosmetic_overrides_name_3k_dlc04_campaign_group_cosmetic_tag_faction_name_lu_kang_world_leader	Kingdom of Guiyang	false
campaign_group_faction_cosmetic_overrides_name_3k_dlc05_campaign_group_cosmetic_tag_faction_name_shi_wu_separatists_world_leader	Kingdom of Nanhai Separatists	false
campaign_group_faction_cosmetic_overrides_name_3k_main_campaign_group_cosmetic_tag_faction_name_ba_separatists_4	Kingdom of Ba Separatists	false
campaign_group_faction_cosmetic_overrides_name_ep_campaign_group_faction_cosmetics_prince_of_ba_separatists	Lady of Ba Separatists	false
campaign_group_faction_cosmetic_overrides_name_3k_dlc05_campaign_group_cosmetic_tag_faction_name_xu_zhao_3	Duchy of Wu	false
campaign_group_faction_cosmetic_overrides_name_3k_main_campaign_group_cosmetic_tag_faction_name_lujiang_3	Duchy of Lujiang	false
campaign_group_faction_cosmetic_overrides_name_3k_dlc04_campaign_group_cosmetic_tag_faction_name_prince_liu_chong_separatists_3	Duchy of Chen Separatists	false
campaign_group_faction_cosmetic_overrides_name_3k_dlc05_campaign_group_cosmetic_tag_faction_name_lu_bu_3	Duchy of Yin	false
campaign_group_faction_cosmetic_overrides_name_ep_campaign_group_faction_cosmetics_prince_of_huainan_separatists	Lady of Huainan Separatists	false
campaign_group_faction_cosmetic_overrides_name_3k_main_campaign_group_cosmetic_tag_faction_name_chengdu_4	Kingdom of Shu	false
campaign_group_faction_cosmetic_overrides_name_3k_dlc04_campaign_group_cosmetic_tag_faction_name_ding_yuan_separatists_4	Kingdom of Bing Separatists	false
campaign_group_faction_cosmetic_overrides_name_3k_dlc05_campaign_group_cosmetic_tag_faction_name_yuan_tan_separatists_world_leader	Kingdom of Nie Separatists	false
campaign_group_faction_cosmetic_overrides_name_3k_main_campaign_group_cosmetic_tag_faction_name_xindu_3	Duchy of Xindu	false
campaign_group_faction_cosmetic_overrides_name_3k_main_campaign_group_cosmetic_tag_faction_name_zhang_yan_hero_wood	PH	false
campaign_group_faction_cosmetic_overrides_name_3k_main_campaign_group_cosmetic_tag_faction_name_luoyang_separatists_world_leader	Kingdom of Luoyang Separatists	false
campaign_group_faction_cosmetic_overrides_name_3k_main_campaign_group_cosmetic_tag_faction_name_changsha_separatists_4	Kingdom of Changsha Separatists	false
campaign_group_faction_cosmetic_overrides_name_3k_main_campaign_group_cosmetic_tag_faction_name_jianye_separatists_world_leader	Kingdom of Danyang Separatists	false
campaign_group_faction_cosmetic_overrides_name_3k_main_campaign_group_cosmetic_tag_faction_name_xiangyang_world_leader	Kingdom of Xiangyang	false
campaign_group_faction_cosmetic_overrides_name_3k_dlc05_campaign_group_cosmetic_tag_faction_name_xu_gong_separatists_4	Kingdom of Chao Separatists	false
campaign_group_faction_cosmetic_overrides_name_3k_main_campaign_group_cosmetic_tag_faction_name_lujiang_world_leader	Kingdom of Lujiang	false
campaign_group_faction_cosmetic_overrides_name_3k_dlc05_campaign_group_cosmetic_tag_faction_name_wu_jing_4	Kingdom of Xu	false
campaign_group_faction_cosmetic_overrides_name_3k_main_campaign_group_cosmetic_tag_faction_name_badong_separatists_world_leader	Kingdom of Badong Separatists	false
campaign_group_faction_cosmetic_overrides_name_3k_main_campaign_group_cosmetic_tag_faction_name_yuan_separatists_3	Duchy of Song Separatists	false
campaign_group_faction_cosmetic_overrides_name_3k_main_campaign_group_cosmetic_tag_faction_name_kong_zhou_4	Kingdom of Chen	false
campaign_group_faction_cosmetic_overrides_name_3k_dlc05_campaign_group_cosmetic_tag_faction_name_sun_ce_separatists_world_leader		false
campaign_group_faction_cosmetic_overrides_name_3k_main_campaign_group_cosmetic_tag_faction_name_henei_world_leader	Kingdom of Henei	false
campaign_group_faction_cosmetic_overrides_name_3k_dlc05_campaign_group_cosmetic_tag_faction_name_shi_huang_separatists_world_leader	Kingdom of Cangwu Separatists	false
campaign_group_faction_cosmetic_overrides_name_3k_main_campaign_group_cosmetic_tag_faction_name_kuaiji_separatists_3	Duchy of Kuaiji Separatists	false
campaign_group_faction_cosmetic_overrides_name_3k_dlc04_campaign_group_cosmetic_tag_faction_name_ding_yuan_separatists_3	Duchy of Bing Separatists	false
campaign_group_faction_cosmetic_overrides_name_3k_main_campaign_group_cosmetic_tag_faction_name_donghai_separatists_4	Kingdom of Donghai Separatists	false
campaign_group_faction_cosmetic_overrides_name_3k_dlc05_campaign_group_cosmetic_tag_faction_name_yang_feng_separatists_3	Duchy of Wey Separatists	false
campaign_group_faction_cosmetic_overrides_name_ep_campaign_group_faction_cosmetics_prince_of_qiao_separatists	Lady of Qiao Separatists	false
campaign_group_faction_cosmetic_overrides_name_ep_campaign_group_faction_cosmetics_prince_of_piling	Lady of Piling	false
campaign_group_faction_cosmetic_overrides_name_ep_campaign_group_faction_cosmetics_prince_of_yangzhou_separatists	Lady of Yangzhou Separatists	false
campaign_group_faction_cosmetic_overrides_name_3k_dlc04_campaign_group_cosmetic_tag_faction_name_wang_rui_separatists_world_leader	Kingdom of Xu Separatists	false
campaign_group_faction_cosmetic_overrides_name_3k_dlc04_campaign_group_cosmetic_tag_faction_name_yuan_yi_separatists_3	Duchy of Pei Separatists	false
campaign_group_faction_cosmetic_overrides_name_ep_campaign_group_faction_cosmetics_prince_of_kuaiji_separatists	Lady of Kuaiji Separatists	false
campaign_group_faction_cosmetic_overrides_name_3k_main_campaign_group_cosmetic_tag_faction_name_zhang_yan_world_leader	Kingdom of Heishan	false
campaign_group_faction_cosmetic_overrides_name_3k_main_campaign_group_cosmetic_tag_faction_name_jianye_separatists_3	Duchy of Danyang Separatists	false
campaign_group_faction_cosmetic_overrides_name_3k_main_campaign_group_cosmetic_tag_faction_name_gaoliang_separatists_4	Kingdom of Gaoliang Separatists	false
campaign_group_faction_cosmetic_overrides_name_3k_main_campaign_group_cosmetic_tag_faction_name_yulin_4	Kingdom of Yulin	false
campaign_group_faction_cosmetic_overrides_name_3k_dlc05_campaign_group_cosmetic_tag_faction_name_zang_ba_4	Kingdom of Lu	false
campaign_group_faction_cosmetic_overrides_name_3k_main_campaign_group_cosmetic_tag_faction_name_donglai_separatists_world_leader	Kingdom of Donglai Separatists	false
campaign_group_faction_cosmetic_overrides_name_3k_dlc04_campaign_group_cosmetic_tag_faction_name_liu_hong_world_leader	Kingdom of Nan	false
campaign_group_faction_cosmetic_overrides_name_3k_main_campaign_group_cosmetic_tag_faction_name_luoyang_world_leader	Kingdom of Luoyang	false
campaign_group_faction_cosmetic_overrides_name_3k_dlc04_campaign_group_cosmetic_tag_faction_name_lu_kang_4	Kingdom of Guiyang	false
campaign_group_faction_cosmetic_overrides_name_3k_main_campaign_group_cosmetic_tag_faction_name_jia_long_4	Kingdom of Jianwei	false
campaign_group_faction_cosmetic_overrides_name_3k_main_campaign_group_cosmetic_tag_faction_name_yu_separatists_world_leader	Kingdom of Yu Separatists	false
campaign_group_faction_cosmetic_overrides_name_3k_dlc05_campaign_group_cosmetic_tag_faction_name_yang_feng_separatists_4	Kingdom of Wey Separatists	false
campaign_group_faction_cosmetic_overrides_name_3k_main_campaign_group_cosmetic_tag_faction_name_donghai_world_leader	Kingdom of Donghai	false
campaign_group_faction_cosmetic_overrides_name_3k_dlc05_campaign_group_cosmetic_tag_faction_name_xu_gong_4	Kingdom of Chao	false
campaign_group_faction_cosmetic_overrides_name_ep_campaign_group_faction_cosmetics_prince_of_donghai	Lady of Donghai	false
campaign_group_faction_cosmetic_overrides_name_3k_dlc05_campaign_group_cosmetic_tag_faction_name_xu_gong_separatists_3	Duchy of Chao Separatists	false
campaign_group_faction_cosmetic_overrides_name_3k_main_campaign_group_cosmetic_tag_faction_name_yanmen_separatists_world_leader	Kingdom of Yanmen Separatists	false
campaign_group_faction_cosmetic_overrides_name_3k_main_campaign_group_cosmetic_tag_faction_name_kuaiji_3	Duchy of Kuaiji	false
campaign_group_faction_cosmetic_overrides_name_3k_main_campaign_group_cosmetic_tag_faction_name_zhai_rong_separatists_3	Duchy of Chao Separatists	false
campaign_group_faction_cosmetic_overrides_name_ep_campaign_group_faction_cosmetics_prince_of_jincheng	Lady of Jincheng	false
campaign_group_faction_cosmetic_overrides_name_3k_main_campaign_group_cosmetic_tag_faction_name_hedong_world_leader	Kingdom of Hedong	false
campaign_group_faction_cosmetic_overrides_name_3k_main_campaign_group_cosmetic_tag_faction_name_jincheng_4	Kingdom of Jincheng	false
campaign_group_faction_cosmetic_overrides_name_3k_main_campaign_group_cosmetic_tag_faction_name_fuling_4	Kingdom of Fuling	false
campaign_group_faction_cosmetic_overrides_name_3k_main_campaign_group_cosmetic_tag_faction_name_daijun_4	Kingdom of Daijun	false
campaign_group_faction_cosmetic_overrides_name_3k_main_campaign_group_cosmetic_tag_faction_name_gongsun_separatists_4	Kingdom of Yan Separatists	false
campaign_group_faction_cosmetic_overrides_name_3k_dlc05_campaign_group_cosmetic_tag_faction_name_zhu_fu_3	Duchy of Kui	false
campaign_group_faction_cosmetic_overrides_name_3k_dlc04_campaign_group_cosmetic_tag_faction_name_lu_kang_separatists_world_leader	Kingdom of Guiyang Separatists	false
campaign_group_faction_cosmetic_overrides_name_3k_main_campaign_group_cosmetic_tag_faction_name_gongsun_du_4	Kingdom of Guzhu	false
campaign_group_faction_cosmetic_overrides_name_3k_main_campaign_group_cosmetic_tag_faction_name_liu_yan_world_leader	Kingdom of Xun	false
campaign_group_faction_cosmetic_overrides_name_3k_main_campaign_group_cosmetic_tag_faction_name_wudu_separatists_3	Duchy of Wudu Separatists	false
campaign_group_faction_cosmetic_overrides_name_3k_dlc04_campaign_group_cosmetic_tag_faction_name_dong_he_separatists_3	Duchy of Yi Separatists	false
campaign_group_faction_cosmetic_overrides_name_3k_main_campaign_group_cosmetic_tag_faction_name_xiapi_separatists_4	Kingdom of Xiapi Separatists	false
campaign_group_faction_cosmetic_overrides_name_3k_main_campaign_group_cosmetic_tag_faction_name_han_separatists_4	Kingdom of Nie Separatists	false
campaign_group_faction_cosmetic_overrides_name_3k_main_campaign_group_cosmetic_tag_faction_name_gaoliang_separatists_world_leader	Kingdom of Gaoliang Separatists	false
campaign_group_faction_cosmetic_overrides_name_3k_main_campaign_group_cosmetic_tag_faction_name_poyang_world_leader	Kingdom of Poyang	false
campaign_group_faction_cosmetic_overrides_name_3k_dlc04_campaign_group_cosmetic_tag_faction_name_cao_song_separatists_4	Kingdom of Yang Separatists	false
campaign_group_faction_cosmetic_overrides_name_3k_dlc04_campaign_group_cosmetic_tag_faction_name_bian_zhang_3	Duchy of Zhang	false
campaign_group_faction_cosmetic_overrides_name_3k_main_campaign_group_cosmetic_tag_faction_name_langye_world_leader	Kingdom of Langye	false
campaign_group_faction_cosmetic_overrides_name_3k_main_campaign_group_cosmetic_tag_faction_name_pingyuan_world_leader	Kingdom of Pingyuan	false
campaign_group_faction_cosmetic_overrides_name_3k_main_campaign_group_cosmetic_tag_faction_name_zheng_jiang_4	Tai Dominion	false
campaign_group_faction_cosmetic_overrides_name_3k_main_campaign_group_cosmetic_tag_faction_name_weijun_separatists_world_leader	Kingdom of Weijun Separatists	false
campaign_group_faction_cosmetic_overrides_name_ep_campaign_group_faction_cosmetics_prince_of_zhao	Lady of Zhao	false
campaign_group_faction_cosmetic_overrides_name_3k_main_campaign_group_cosmetic_tag_faction_name_weijun_separatists_4	Kingdom of Weijun Separatists	false
campaign_group_faction_cosmetic_overrides_name_3k_dlc05_campaign_group_cosmetic_tag_faction_name_yuan_tan_3	Duchy of Nie	false
campaign_group_faction_cosmetic_overrides_name_3k_main_campaign_group_cosmetic_tag_faction_name_xihe_separatists_world_leader	Kingdom of Xihe Separatists	false
campaign_group_faction_cosmetic_overrides_name_3k_main_campaign_group_cosmetic_tag_faction_name_nanyang_world_leader	Kingdom of Nanyang	false
campaign_group_faction_cosmetic_overrides_name_ep_campaign_group_faction_cosmetics_prince_of_cangwu	Lady of Cangwu	false
campaign_group_faction_cosmetic_overrides_name_3k_dlc04_campaign_group_cosmetic_tag_faction_name_xin_xuan_separatists_world_leader	Kingdom of Jing Separatists	false
campaign_group_faction_cosmetic_overrides_name_3k_main_campaign_group_cosmetic_tag_faction_name_shi_xie_3	Duchy of Jiuzhen	false
campaign_group_faction_cosmetic_overrides_name_3k_main_campaign_group_cosmetic_tag_faction_name_chengdu_separatists_3	Duchy of Shu Separatists	false
campaign_group_faction_cosmetic_overrides_name_3k_main_campaign_group_cosmetic_tag_faction_name_runan_separatists_3	Duchy of Runan Separatists	false
campaign_group_faction_cosmetic_overrides_name_3k_dlc05_campaign_group_cosmetic_tag_faction_name_shi_huang_4	Kingdom of Cangwu	false
campaign_group_faction_cosmetic_overrides_name_ep_campaign_group_faction_cosmetics_prince_of_han	Lady of Han	false
campaign_group_faction_cosmetic_overrides_name_3k_main_campaign_group_cosmetic_tag_faction_name_shangyong_separatists_3	Duchy of Shangyong Separatists	false
campaign_group_faction_cosmetic_overrides_name_ep_campaign_group_faction_cosmetics_prince_of_shunyang	Lady of Shunyang	false
campaign_group_faction_cosmetic_overrides_name_3k_dlc05_campaign_group_cosmetic_tag_faction_name_shi_yi_separatists_3	Duchy of Hepu Separatists	false
campaign_group_faction_cosmetic_overrides_name_3k_main_campaign_group_cosmetic_tag_faction_name_cao_cao_world_leader	Kingdom of Wei	false
campaign_group_faction_cosmetic_overrides_name_3k_dlc04_campaign_group_cosmetic_tag_faction_name_lu_zhi_separatists_4	Kingdom of Guangyang Separatists	false
campaign_group_faction_cosmetic_overrides_name_3k_dlc04_campaign_group_cosmetic_tag_faction_name_bian_zhang_4	Kingdom of Zhang	false
campaign_group_faction_cosmetic_overrides_name_3k_main_campaign_group_cosmetic_tag_faction_name_baxi_separatists_world_leader	Kingdom of Baxi Separatists	false
campaign_group_faction_cosmetic_overrides_name_ep_campaign_group_faction_cosmetics_prince_of_yiyang_separatists	Lady of Yiyang Separatists	false
campaign_group_faction_cosmetic_overrides_name_3k_main_campaign_group_cosmetic_tag_faction_name_sheng_xian_separatists_4	Kingdom of Wu Separatists	false
campaign_group_faction_cosmetic_overrides_name_3k_dlc05_campaign_group_cosmetic_tag_faction_name_shi_yi_3	Duchy of Hepu	false
campaign_group_faction_cosmetic_overrides_name_3k_main_campaign_group_cosmetic_tag_faction_name_youzhou_4	Kingdom of Guangyang	false
campaign_group_faction_cosmetic_overrides_name_3k_main_campaign_group_cosmetic_tag_faction_name_zhang_yang_world_leader	Kingdom of Zhongshan	false
campaign_group_faction_cosmetic_overrides_name_3k_main_campaign_group_cosmetic_tag_faction_name_jianning_4	Kingdom of Jianning	false
campaign_group_faction_cosmetic_overrides_name_ep_campaign_group_faction_cosmetics_prince_of_zhangwu	Lady of Zhangwu	false
campaign_group_faction_cosmetic_overrides_name_3k_main_campaign_group_cosmetic_tag_faction_name_huang_zu_separatists_world_leader	Kingdom of Sui Separatists	false
campaign_group_faction_cosmetic_overrides_name_3k_main_campaign_group_cosmetic_tag_faction_name_zangke_separatists_3	Duchy of Zangke Separatists	false
campaign_group_faction_cosmetic_overrides_name_3k_main_campaign_group_cosmetic_tag_faction_name_zhang_yang_separatists_world_leader	Kingdom of Zhongshan Separatists	false
campaign_group_faction_cosmetic_overrides_name_3k_dlc04_campaign_group_cosmetic_tag_faction_name_bian_zhang_separatists_3	Duchy of Zhang Separatists	false
campaign_group_faction_cosmetic_overrides_name_3k_main_campaign_group_cosmetic_tag_faction_name_yangzhou_separatists_3	Duchy of Huainan Separatists	false
campaign_group_faction_cosmetic_overrides_name_ep_campaign_group_faction_cosmetics_prince_of_langye	Lady of Langye	false
campaign_group_faction_cosmetic_overrides_name_3k_main_campaign_group_cosmetic_tag_faction_name_yuan_shu_separatists_world_leader	Kingdom of Zhong Separatists	false
campaign_group_faction_cosmetic_overrides_name_3k_main_campaign_group_cosmetic_tag_faction_name_beihai_world_leader	Kingdom of Beihai	false
campaign_group_faction_cosmetic_overrides_name_ep_campaign_group_faction_cosmetics_prince_of_gaoyang	Lady of Gaoyang	false
campaign_group_faction_cosmetic_overrides_name_ep_campaign_group_faction_cosmetics_prince_of_dongping	Lady of Dongping	false
campaign_group_faction_cosmetic_overrides_name_3k_main_campaign_group_cosmetic_tag_faction_name_weijun_separatists_3	Duchy of Weijun Separatists	false
campaign_group_faction_cosmetic_overrides_name_3k_main_campaign_group_cosmetic_tag_faction_name_ye_separatists_3	Duchy of Ye Separatists	false
campaign_group_faction_cosmetic_overrides_name_3k_main_campaign_group_cosmetic_tag_faction_name_xihe_separatists_4	Kingdom of Xihe Separatists	false
campaign_group_faction_cosmetic_overrides_name_3k_main_campaign_group_cosmetic_tag_faction_name_lingling_world_leader	Kingdom of Lingling	false
campaign_group_faction_cosmetic_overrides_name_ep_campaign_group_faction_cosmetics_prince_of_wu_separatists	Lady of Wu Separatists	false
campaign_group_faction_cosmetic_overrides_name_3k_main_campaign_group_cosmetic_tag_faction_name_dong_zhuo_4	Kingdom of Zhou	false
campaign_group_faction_cosmetic_overrides_name_3k_main_campaign_group_cosmetic_tag_faction_name_kuaiji_separatists_world_leader	Kingdom of Kuaiji Separatists	false
campaign_group_faction_cosmetic_overrides_name_3k_main_campaign_group_cosmetic_tag_faction_name_kong_zhou_separatists_3	Duchy of Chen Separatists	false
campaign_group_faction_cosmetic_overrides_name_3k_main_campaign_group_cosmetic_tag_faction_name_donglai_3	Duchy of Donglai	false
campaign_group_faction_cosmetic_overrides_name_3k_main_campaign_group_cosmetic_tag_faction_name_wang_lang_separatists_4	Kingdom of Tan Separatists	false
campaign_group_faction_cosmetic_overrides_name_3k_main_campaign_group_cosmetic_tag_faction_name_yu_4	Kingdom of Yu	false
campaign_group_faction_cosmetic_overrides_name_3k_main_campaign_group_cosmetic_tag_faction_name_jingzhou_world_leader	Kingdom of Jingzhou	false
campaign_group_faction_cosmetic_overrides_name_3k_main_campaign_group_cosmetic_tag_faction_name_jianye_3	Duchy of Danyang	false
campaign_group_faction_cosmetic_overrides_name_3k_main_campaign_group_cosmetic_tag_faction_name_anding_separatists_4	Kingdom of Anding Separatists	false
campaign_group_faction_cosmetic_overrides_name_3k_main_campaign_group_cosmetic_tag_faction_name_guangling_separatists_3	Duchy of Guangling Separatists	false
campaign_group_faction_cosmetic_overrides_name_ep_campaign_group_faction_cosmetics_prince_of_nanyang_separatists	Lady of Nanyang Separatists	false
campaign_group_faction_cosmetic_overrides_name_3k_main_campaign_group_cosmetic_tag_faction_name_jianan_world_leader	Kingdom of Jian'an	false
campaign_group_faction_cosmetic_overrides_name_3k_dlc05_campaign_group_cosmetic_tag_faction_name_yang_feng_3	Duchy of Wey	false
campaign_group_faction_cosmetic_overrides_name_3k_dlc05_campaign_group_cosmetic_tag_faction_name_yuan_tan_separatists_3	Duchy of Nie Separatists	false
campaign_group_faction_cosmetic_overrides_name_3k_main_campaign_group_cosmetic_tag_faction_name_shi_xie_4	Kingdom of Jiuzhen	false
campaign_group_faction_cosmetic_overrides_name_3k_main_campaign_group_cosmetic_tag_faction_name_jianan_separatists_3	Duchy of Jian'an Separatists	false
campaign_group_faction_cosmetic_overrides_name_3k_main_campaign_group_cosmetic_tag_faction_name_wudu_world_leader	Kingdom of Wudu	false
campaign_group_faction_cosmetic_overrides_name_3k_main_campaign_group_cosmetic_tag_faction_name_gao_gan_separatists_world_leader	Kingdom of Bing Separatists	false
campaign_group_faction_cosmetic_overrides_name_3k_main_campaign_group_cosmetic_tag_faction_name_penchang_world_leader	Kingdom of Pengcheng	false
campaign_group_faction_cosmetic_overrides_name_3k_main_campaign_group_cosmetic_tag_faction_name_zangke_separatists_world_leader	Kingdom of Zangke Separatists	false
campaign_group_faction_cosmetic_overrides_name_3k_main_campaign_group_cosmetic_tag_faction_name_liu_yu_separatists_world_leader	Kingdom of Daijun Separatists	false
campaign_group_faction_cosmetic_overrides_name_3k_dlc04_campaign_group_cosmetic_tag_faction_name_liu_hong_separatists_3	Duchy of Nan Separatists	false
campaign_group_faction_cosmetic_overrides_name_3k_main_campaign_group_cosmetic_tag_faction_name_jianye_world_leader	Kingdom of Danyang	false
campaign_group_faction_cosmetic_overrides_name_3k_main_campaign_group_cosmetic_tag_faction_name_lady_bu_lianshi_hero_wood	PH	false
campaign_group_faction_cosmetic_overrides_name_3k_main_campaign_group_cosmetic_tag_faction_name_henei_separatists_world_leader	Kingdom of Henei Separatists	false
campaign_group_faction_cosmetic_overrides_name_3k_main_campaign_group_cosmetic_tag_all_factions		false
campaign_group_faction_cosmetic_overrides_name_3k_main_campaign_group_cosmetic_tag_faction_name_tao_qian_separatists_4	Kingdom of Lu Separatists	false
campaign_group_faction_cosmetic_overrides_name_3k_dlc04_campaign_group_cosmetic_tag_faction_name_liu_xun_separatists_world_leader	Kingdom of Chengyang Separatists	false
campaign_group_faction_cosmetic_overrides_name_3k_main_campaign_group_cosmetic_tag_faction_name_lujiang_separatists_world_leader	Kingdom of Lujiang Separatists	false
campaign_group_faction_cosmetic_overrides_name_3k_dlc05_campaign_group_cosmetic_tag_faction_name_shi_yi_separatists_world_leader	Kingdom of Hepu Separatists	false
campaign_group_faction_cosmetic_overrides_name_3k_main_campaign_group_cosmetic_tag_faction_name_yuan_shao_hero_earth	PH	false
campaign_group_faction_cosmetic_overrides_name_3k_main_campaign_group_cosmetic_tag_faction_name_zhang_yang_separatists_4	Kingdom of Zhongshan Separatists	false
campaign_group_faction_cosmetic_overrides_name_3k_dlc05_campaign_group_cosmetic_tag_faction_name_zhu_fu_separatists_3	Duchy of Kui Separatists	false
campaign_group_faction_cosmetic_overrides_name_3k_dlc04_campaign_group_cosmetic_tag_faction_name_chen_gui_3	Duchy of Qing	false
campaign_group_faction_cosmetic_overrides_name_3k_dlc05_campaign_group_cosmetic_tag_faction_name_hua_xin_world_leader	Kingdom of Huainan	false
campaign_group_faction_cosmetic_overrides_name_3k_main_campaign_group_cosmetic_tag_faction_name_youbeiping_3	Duchy of Youbeiping	false
campaign_group_faction_cosmetic_overrides_name_3k_main_campaign_group_cosmetic_tag_faction_name_yu_separatists_4	Kingdom of Yu Separatists	false
campaign_group_faction_cosmetic_overrides_name_3k_main_campaign_group_cosmetic_tag_faction_name_liu_bei_separatists_world_leader	Kingdom of Shu-Han Separatists	false
campaign_group_faction_cosmetic_overrides_name_3k_dlc05_campaign_group_cosmetic_tag_faction_name_lu_bu_separatists_4	Kingdom of Yin Separatists	false
campaign_group_faction_cosmetic_overrides_name_ep_campaign_group_faction_cosmetics_prince_of_changsha_separatists	Lady of Changsha Separatists	false
campaign_group_faction_cosmetic_overrides_name_3k_main_campaign_group_cosmetic_tag_faction_name_liu_yao_3	Duchy of Yue	false
campaign_group_faction_cosmetic_overrides_name_ep_campaign_group_faction_cosmetics_prince_of_zhao_separatists	Lady of Zhao Separatists	false
campaign_group_faction_cosmetic_overrides_name_3k_main_campaign_group_cosmetic_tag_faction_name_kong_rong_3	Duchy of Qi	false
campaign_group_faction_cosmetic_overrides_name_3k_main_campaign_group_cosmetic_tag_faction_name_zhang_separatists_3	Duchy of Hanning Separatists	false
campaign_group_faction_cosmetic_overrides_name_ep_campaign_group_faction_cosmetics_prince_of_wudu_separatists	Lady of Wudu Separatists	false
campaign_group_faction_cosmetic_overrides_name_3k_main_campaign_group_cosmetic_tag_faction_name_yu_separatists_3	Duchy of Yu Separatists	false
campaign_group_faction_cosmetic_overrides_name_3k_dlc05_campaign_group_cosmetic_tag_faction_name_tian_kai_separatists_4	Kingdom of Zhao Separatists	false
campaign_group_faction_cosmetic_overrides_name_3k_main_campaign_group_cosmetic_tag_faction_name_jingzhou_separatists_3	Duchy of Jingzhou Separatists	false
campaign_group_faction_cosmetic_overrides_name_ep_campaign_group_faction_cosmetics_prince_of_engcheng_separatists	Lady of Pengcheng Separatists	false
campaign_group_faction_cosmetic_overrides_name_3k_main_campaign_group_cosmetic_tag_faction_name_bohai_separatists_4	Kingdom of Bohai Separatists	false
campaign_group_faction_cosmetic_overrides_name_3k_main_campaign_group_cosmetic_tag_faction_name_liu_dai_4	Kingdom of Tang	false
campaign_group_faction_cosmetic_overrides_name_ep_campaign_group_faction_cosmetics_prince_of_dai_separatists	Lady of Dai Separatists	false
campaign_group_faction_cosmetic_overrides_name_3k_main_campaign_group_cosmetic_tag_faction_name_wang_kuang_world_leader	Kingdom of Wang	false
campaign_group_faction_cosmetic_overrides_name_3k_main_campaign_group_cosmetic_tag_faction_name_jiangyang_3	Duchy of Jiangyang	false
campaign_group_faction_cosmetic_overrides_name_3k_dlc05_campaign_group_cosmetic_tag_faction_name_shi_wu_4	Kingdom of Nanhai	false
campaign_group_faction_cosmetic_overrides_name_3k_main_campaign_group_cosmetic_tag_faction_name_penchang_separatists_3	Duchy of Pengcheng Separatists	false
campaign_group_faction_cosmetic_overrides_name_3k_dlc04_campaign_group_cosmetic_tag_faction_name_liu_xun_3	Duchy of Chengyang	false
campaign_group_faction_cosmetic_overrides_name_3k_main_campaign_group_cosmetic_tag_faction_name_baxi_world_leader	Kingdom of Baxi	false
campaign_group_faction_cosmetic_overrides_name_3k_main_campaign_group_cosmetic_tag_faction_name_huang_zu_world_leader	Kingdom of Sui	false
campaign_group_faction_cosmetic_overrides_name_3k_dlc05_campaign_group_cosmetic_tag_faction_name_xue_li_world_leader	Kingdom of Zhongli	false
campaign_group_faction_cosmetic_overrides_name_3k_main_campaign_group_cosmetic_tag_faction_name_gongsun_du_separatists_4	Kingdom of Guzhu Separatists	false
campaign_group_faction_cosmetic_overrides_name_3k_main_campaign_group_cosmetic_tag_faction_name_nanhai_separatists_4	Kingdom of Nanhai Separatists	false
campaign_group_faction_cosmetic_overrides_name_3k_main_campaign_group_cosmetic_tag_faction_name_penchang_4	Kingdom of Pengcheng	false
campaign_group_faction_cosmetic_overrides_name_ep_campaign_group_faction_cosmetics_prince_of_rencheng	Lady of Rencheng	false
campaign_group_faction_cosmetic_overrides_name_3k_main_campaign_group_cosmetic_tag_faction_name_dongjun_separatists_4	Kingdom of Dongjun Separatists	false
campaign_group_faction_cosmetic_overrides_name_3k_main_campaign_group_cosmetic_tag_faction_name_tong'an_separatists_3	Duchy of Tong'an Separatists	false
campaign_group_faction_cosmetic_overrides_name_3k_main_campaign_group_cosmetic_tag_faction_name_xiangyang_separatists_4	Kingdom of Xiangyang Separatists	false
campaign_group_faction_cosmetic_overrides_name_3k_main_campaign_group_cosmetic_tag_faction_name_nanyang_4	Kingdom of Nanyang	false
campaign_group_faction_cosmetic_overrides_name_3k_main_campaign_group_cosmetic_tag_faction_name_youzhou_separatists_3	Duchy of Guangyang Separatists	false
campaign_group_faction_cosmetic_overrides_name_ep_campaign_group_faction_cosmetics_prince_of_qin_separatists	Lady of Qin Separatists	false
campaign_group_faction_cosmetic_overrides_name_3k_main_campaign_group_cosmetic_tag_faction_name_taiyuan_world_leader	Kingdom of Taiyuan	false
campaign_group_faction_cosmetic_overrides_name_3k_main_campaign_group_cosmetic_tag_faction_name_gongsun_du_separatists_3	Duchy of Guzhu Separatists	false
campaign_group_faction_cosmetic_overrides_name_3k_main_campaign_group_cosmetic_tag_faction_name_sun_ce_hero_fire	PH	false
campaign_group_faction_cosmetic_overrides_name_3k_dlc05_campaign_group_cosmetic_tag_faction_name_shi_wu_separatists_4	Kingdom of Nanhai Separatists	false
campaign_group_faction_cosmetic_overrides_name_3k_main_campaign_group_cosmetic_tag_faction_name_dongjun_4	Kingdom of Dongjun	false
campaign_group_faction_cosmetic_overrides_name_3k_main_campaign_group_cosmetic_tag_faction_name_yu_3	Duchy of Yu	false
campaign_group_faction_cosmetic_overrides_name_ep_campaign_group_faction_cosmetics_prince_of_henei	Lady of Henei	false
campaign_group_faction_cosmetic_overrides_name_3k_main_campaign_group_cosmetic_tag_faction_name_ye_separatists_world_leader	Kingdom of Ye Separatists	false
campaign_group_faction_cosmetic_overrides_name_3k_main_campaign_group_cosmetic_tag_faction_name_zhang_yan_4	Kingdom of Heishan	false
campaign_group_faction_cosmetic_overrides_name_3k_dlc04_campaign_group_cosmetic_tag_faction_name_chu_gong_separatists_3	Duchy of Sili Separatists	false
campaign_group_faction_cosmetic_overrides_name_3k_dlc04_campaign_group_cosmetic_tag_faction_name_wang_rui_separatists_4	Kingdom of Xu Separatists	false
campaign_group_faction_cosmetic_overrides_name_3k_dlc05_campaign_group_cosmetic_tag_faction_name_tian_kai_3	Duchy of Zhao	false
campaign_group_faction_cosmetic_overrides_name_ep_campaign_group_faction_cosmetics_prince_of_qinghe_separatists	Lady of Qinghe Separatists	false
campaign_group_faction_cosmetic_overrides_name_3k_main_campaign_group_cosmetic_tag_faction_name_baxi_3	Duchy of Baxi	false
campaign_group_faction_cosmetic_overrides_name_3k_dlc05_campaign_group_cosmetic_tag_faction_name_shi_wu_3	Duchy of Nanhai	false
campaign_group_faction_cosmetic_overrides_name_3k_main_campaign_group_cosmetic_tag_faction_name_wuling_3	Duchy of Wuling	false
campaign_group_faction_cosmetic_overrides_name_3k_dlc05_campaign_group_cosmetic_tag_faction_name_zang_ba_separatists_4	Kingdom of Lu Separatists	false
campaign_group_faction_cosmetic_overrides_name_ep_campaign_group_faction_cosmetics_prince_of_wuling_separatists	Lady of Wuling Separatists	false
campaign_group_faction_cosmetic_overrides_name_3k_main_campaign_group_cosmetic_tag_faction_name_zhang_chao_world_leader	Kingdom of Zhongwu	false
campaign_group_faction_cosmetic_overrides_name_ep_campaign_group_faction_cosmetics_prince_of_yuzhang_separatists	Lady of Yuzhang Separatists	false
campaign_group_faction_cosmetic_overrides_name_3k_main_campaign_group_cosmetic_tag_faction_name_sheng_xian_4	Kingdom of Wu	false
campaign_group_faction_cosmetic_overrides_name_ep_campaign_group_faction_cosmetics_prince_of_gaoyang_separatists	Lady of Gaoyang Separatists	false
campaign_group_faction_cosmetic_overrides_name_ep_campaign_group_faction_cosmetics_prince_of_donghai_separatists	Lady of Donghai Separatists	false
campaign_group_faction_cosmetic_overrides_name_ep_campaign_group_faction_cosmetics_prince_of_luling_separatists	Lady of Luling Separatists	false
campaign_group_faction_cosmetic_overrides_name_3k_main_campaign_group_cosmetic_tag_faction_name_liu_yu_world_leader	Kingdom of Daijun	false
campaign_group_faction_cosmetic_overrides_name_ep_campaign_group_faction_cosmetics_prince_of_changsha	Lady of Changsha	false
campaign_group_faction_cosmetic_overrides_name_3k_main_campaign_group_cosmetic_tag_faction_name_zhang_yang_4	Kingdom of Zhongshan	false
campaign_group_faction_cosmetic_overrides_name_3k_main_campaign_group_cosmetic_tag_faction_name_penchang_3	Duchy of Pengcheng	false
campaign_group_faction_cosmetic_overrides_name_3k_dlc04_campaign_group_cosmetic_tag_faction_name_chen_gui_separatists_4	Kingdom of Qing Separatists	false
campaign_group_faction_cosmetic_overrides_name_3k_main_campaign_group_cosmetic_tag_faction_name_donglai_separatists_3	Duchy of Donglai Separatists	false
campaign_group_faction_cosmetic_overrides_name_3k_main_campaign_group_cosmetic_tag_faction_name_youzhou_separatists_world_leader	Kingdom of Guangyang Separatists	false
campaign_group_faction_cosmetic_overrides_name_3k_main_campaign_group_cosmetic_tag_faction_name_zhang_chao_separatists_world_leader	Kingdom of Zhongwu Separatists	false
campaign_group_faction_cosmetic_overrides_name_ep_campaign_group_faction_cosmetics_prince_of_hejian	Lady of Hejian	false
campaign_group_faction_cosmetic_overrides_name_3k_dlc04_campaign_group_cosmetic_tag_faction_name_dlc04_rebels		false
campaign_group_faction_cosmetic_overrides_name_3k_main_campaign_group_cosmetic_tag_faction_name_hepu_world_leader	Kingdom of Hepu	false
campaign_group_faction_cosmetic_overrides_name_3k_dlc04_campaign_group_cosmetic_tag_faction_name_yuan_yi_4	Kingdom of Pei	false
campaign_group_faction_cosmetic_overrides_name_3k_main_campaign_group_cosmetic_tag_faction_name_donghai_4	Kingdom of Donghai	false
campaign_group_faction_cosmetic_overrides_name_3k_dlc05_campaign_group_cosmetic_tag_faction_name_wu_jing_3	Duchy of Xu	false
campaign_group_faction_cosmetic_overrides_name_ep_campaign_group_faction_cosmetics_prince_of_xiapi	Lady of Xiapi	false
campaign_group_faction_cosmetic_overrides_name_3k_dlc05_campaign_group_cosmetic_tag_faction_name_xu_gong_separatists_world_leader	Kingdom of Chao Separatists	false
campaign_group_faction_cosmetic_overrides_name_3k_main_campaign_group_cosmetic_tag_faction_name_dongjun_separatists_world_leader	Kingdom of Dongjun Separatists	false
campaign_group_faction_cosmetic_overrides_name_3k_main_campaign_group_cosmetic_tag_faction_name_kong_zhou_separatists_4	Kingdom of Chen Separatists	false
campaign_group_faction_cosmetic_overrides_name_3k_dlc04_campaign_group_cosmetic_tag_faction_name_zhou_xin_separatists_world_leader	Kingdom of Jiujiang Separatists	false
campaign_group_faction_cosmetic_overrides_name_3k_main_campaign_group_cosmetic_tag_faction_name_cangwu_3	Duchy of Cangwu	false
campaign_group_faction_cosmetic_overrides_name_3k_main_campaign_group_cosmetic_tag_faction_name_ma_teng_hero_fire	PH	false
campaign_group_faction_cosmetic_overrides_name_3k_main_campaign_group_cosmetic_tag_faction_name_weijun_3	Duchy of Weijun	false
campaign_group_faction_cosmetic_overrides_name_3k_main_campaign_group_cosmetic_tag_faction_name_guangling_4	Kingdom of Guangling	false
campaign_group_faction_cosmetic_overrides_name_3k_main_campaign_group_cosmetic_tag_faction_name_jianning_3	Duchy of Jianning	false
campaign_group_faction_cosmetic_overrides_name_3k_dlc05_campaign_group_cosmetic_tag_faction_name_shi_yi_world_leader	Kingdom of Hepu	false
campaign_group_faction_cosmetic_overrides_name_3k_main_campaign_group_cosmetic_tag_faction_name_changsha_3	Duchy of Changsha	false
campaign_group_faction_cosmetic_overrides_name_3k_dlc05_campaign_group_cosmetic_tag_faction_name_zhu_fu_world_leader	Kingdom of Kui	false
campaign_group_faction_cosmetic_overrides_name_3k_dlc04_campaign_group_cosmetic_tag_faction_name_liang_rebels_separatists_world_leader	Kingdom of Longxi Separatists	false
campaign_group_faction_cosmetic_overrides_name_3k_dlc04_campaign_group_cosmetic_tag_faction_name_liang_rebels_4	Kingdom of Longxi	false
campaign_group_faction_cosmetic_overrides_name_3k_main_campaign_group_cosmetic_tag_faction_name_jia_long_separatists_world_leader	Kingdom of Jianwei Separatists	false
campaign_group_faction_cosmetic_overrides_name_ep_campaign_group_faction_cosmetics_prince_of_chu	Lady of Chu	false
campaign_group_faction_cosmetic_overrides_name_3k_main_campaign_group_cosmetic_tag_faction_name_luling_4	Kingdom of Luling	false
campaign_group_faction_cosmetic_overrides_name_ep_campaign_group_faction_cosmetics_prince_of_jiaozhi	Lady of Jiaozhi	false
campaign_group_faction_cosmetic_overrides_name_3k_main_campaign_group_cosmetic_tag_faction_name_bohai_3	Duchy of Bohai	false
campaign_group_faction_cosmetic_overrides_name_3k_dlc05_campaign_group_cosmetic_tag_faction_name_hua_xin_separatists_4	Kingdom of Huainan Separatists	false
campaign_group_faction_cosmetic_overrides_name_3k_main_campaign_group_cosmetic_tag_faction_name_liu_yan_separatists_4	Kingdom of Xun Separatists	false
campaign_group_faction_cosmetic_overrides_name_3k_dlc04_campaign_group_cosmetic_tag_faction_name_liu_hong_3	Duchy of Nan	false
campaign_group_faction_cosmetic_overrides_name_3k_main_campaign_group_cosmetic_tag_faction_name_zhang_chao_separatists_4	Kingdom of Zhongwu Separatists	false
campaign_group_faction_cosmetic_overrides_name_3k_main_campaign_group_cosmetic_tag_faction_name_zhang_lu_hero_wood	PH	false
campaign_group_faction_cosmetic_overrides_name_ep_campaign_group_faction_cosmetics_prince_of_qi	Lady of Qi	false
campaign_group_faction_cosmetic_overrides_name_3k_main_campaign_group_cosmetic_tag_faction_name_pingyuan_separatists_3	Duchy of Pingyuan Separatists	false
campaign_group_faction_cosmetic_overrides_name_ep_campaign_group_faction_cosmetics_prince_of_poyang	Lady of Poyang	false
campaign_group_faction_cosmetic_overrides_name_3k_main_campaign_group_cosmetic_tag_faction_name_yuan_shu_separatists_3	Duchy of Zhong Separatists	false
campaign_group_faction_cosmetic_overrides_name_3k_main_campaign_group_cosmetic_tag_faction_name_bohai_world_leader	Kingdom of Bohai	false
campaign_group_faction_cosmetic_overrides_name_ep_campaign_group_faction_cosmetics_prince_of_qinghe	Lady of Qinghe	false
campaign_group_faction_cosmetic_overrides_name_3k_main_campaign_group_cosmetic_tag_faction_name_jingzhou_3	Duchy of Jingzhou	false
campaign_group_faction_cosmetic_overrides_name_3k_dlc06_campaign_group_cosmetic_tag_faction_name_nanman_minor_tribes		false
campaign_group_faction_cosmetic_overrides_name_3k_main_campaign_group_cosmetic_tag_faction_name_jia_long_separatists_3	Duchy of Jianwei Separatists	false
campaign_group_faction_cosmetic_overrides_name_ep_campaign_group_faction_cosmetics_jin_empire		false
campaign_group_faction_cosmetic_overrides_name_3k_dlc04_campaign_group_cosmetic_tag_faction_name_zhou_xin_separatists_4	Kingdom of Jiujiang Separatists	false
campaign_group_faction_cosmetic_overrides_name_3k_dlc05_campaign_group_cosmetic_tag_faction_name_xu_gong_world_leader	Kingdom of Chao	false
campaign_group_faction_cosmetic_overrides_name_ep_campaign_group_faction_cosmetics_prince_of_wudu	Lady of Wudu	false
campaign_group_faction_cosmetic_overrides_name_3k_dlc05_campaign_group_cosmetic_tag_faction_name_shi_yi_separatists_4	Kingdom of Hepu Separatists	false
campaign_group_faction_cosmetic_overrides_name_3k_main_campaign_group_cosmetic_tag_faction_name_tong'an_3	Duchy of Tong'an	false
campaign_group_faction_cosmetic_overrides_name_3k_main_campaign_group_cosmetic_tag_faction_name_zhang_liao_hero_metal	PH	false
campaign_group_faction_cosmetic_overrides_name_3k_main_campaign_group_cosmetic_tag_faction_name_han_sui_3	Duchy of Zhai	false
campaign_group_faction_cosmetic_overrides_name_3k_main_campaign_group_cosmetic_tag_faction_name_chengdu_world_leader	Kingdom of Shu	false
campaign_group_faction_cosmetic_overrides_name_3k_main_campaign_group_cosmetic_tag_faction_name_zhang_yang_separatists_3	Duchy of Zhongshan Separatists	false
campaign_group_faction_cosmetic_overrides_name_3k_main_campaign_group_cosmetic_tag_faction_name_nanyang_separatists_4	Kingdom of Nanyang Separatists	false
campaign_group_faction_cosmetic_overrides_name_3k_main_campaign_group_cosmetic_tag_faction_name_kong_zhou_3	Duchy of Chen	false
campaign_group_faction_cosmetic_overrides_name_ep_campaign_group_faction_cosmetics_prince_of_taiyuan	Lady of Taiyuan	false
campaign_group_faction_cosmetic_overrides_name_3k_main_campaign_group_cosmetic_tag_faction_name_runan_4	Kingdom of Runan	false
campaign_group_faction_cosmetic_overrides_name_3k_main_campaign_group_cosmetic_tag_faction_name_zhai_rong_world_leader	Kingdom of Chao	false
campaign_group_faction_cosmetic_overrides_name_3k_dlc05_campaign_group_cosmetic_tag_faction_name_yuan_tan_4	Kingdom of Nie	false
campaign_group_faction_cosmetic_overrides_name_3k_dlc04_campaign_group_cosmetic_tag_faction_name_chen_gui_world_leader	Kingdom of Qing	false
campaign_group_faction_cosmetic_overrides_name_3k_main_campaign_group_cosmetic_tag_faction_name_jincheng_world_leader	Kingdom of Jincheng	false
campaign_group_faction_cosmetic_overrides_name_3k_main_campaign_group_cosmetic_tag_faction_name_yuan_shu_separatists_4	Kingdom of Zhong Separatists	false
campaign_group_faction_cosmetic_overrides_name_3k_main_campaign_group_cosmetic_tag_faction_name_shangdang_3	Duchy of Shangdang	false
campaign_group_faction_cosmetic_overrides_name_3k_main_campaign_group_cosmetic_tag_faction_name_han_sui_hero_metal	PH	false
campaign_group_faction_cosmetic_overrides_name_3k_main_campaign_group_cosmetic_tag_faction_name_pang_de_hero_wood	PH	false
campaign_group_faction_cosmetic_overrides_name_ep_campaign_group_faction_cosmetics_prince_of_hepu	Lady of Hepu	false
campaign_group_faction_cosmetic_overrides_name_3k_main_campaign_group_cosmetic_tag_faction_name_yuan_shu_3	Duchy of Zhong	false
campaign_group_faction_cosmetic_overrides_name_3k_dlc04_campaign_group_cosmetic_tag_faction_name_zhou_xin_4	Kingdom of Jiujiang	false
campaign_group_faction_cosmetic_overrides_name_3k_main_campaign_group_cosmetic_tag_faction_name_youzhou_3	Duchy of Guangyang	false
campaign_group_faction_cosmetic_overrides_name_ep_campaign_group_faction_cosmetics_prince_of_donglai	Lady of Donglai	false
campaign_group_faction_cosmetic_overrides_name_3k_main_campaign_group_cosmetic_tag_faction_name_sheng_xian_separatists_3	Duchy of Wu Separatists	false
campaign_group_faction_cosmetic_overrides_name_3k_main_campaign_group_cosmetic_tag_faction_name_huang_zu_separatists_3	Duchy of Sui Separatists	false
campaign_group_faction_cosmetic_overrides_name_3k_main_campaign_group_cosmetic_tag_faction_name_jiangyang_separatists_4	Kingdom of Jiangyang Separatists	false
campaign_group_faction_cosmetic_overrides_name_3k_dlc04_campaign_group_cosmetic_tag_faction_name_liang_rebels_separatists_4	Kingdom of Longxi Separatists	false
campaign_group_faction_cosmetic_overrides_name_3k_dlc05_campaign_group_cosmetic_tag_faction_name_xue_li_4	Kingdom of Zhongli	false
campaign_group_faction_cosmetic_overrides_name_3k_main_campaign_group_cosmetic_tag_faction_name_changsha_separatists_3	Duchy of Changsha Separatists	false
campaign_group_faction_cosmetic_overrides_name_3k_dlc05_campaign_group_cosmetic_tag_faction_name_sun_ce_4	Kingdom of Wu	false
campaign_group_faction_cosmetic_overrides_name_ep_campaign_group_faction_cosmetics_prince_of_jiangling_separatists	Lady of Jiangling Separatists	false
campaign_group_faction_cosmetic_overrides_name_3k_main_campaign_group_cosmetic_tag_faction_name_pingyuan_separatists_4	Kingdom of Pingyuan Separatists	false
campaign_group_faction_cosmetic_overrides_name_3k_main_campaign_group_cosmetic_tag_faction_name_liaodong_separatists_3	Duchy of Liaodong Separatists	false
campaign_group_faction_cosmetic_overrides_name_ep_campaign_group_faction_cosmetics_prince_of_liaoxi	Lady of Liaoxi	false
campaign_group_faction_cosmetic_overrides_name_3k_dlc04_campaign_group_cosmetic_tag_faction_name_liu_xun_separatists_4	Kingdom of Chengyang Separatists	false
campaign_group_faction_cosmetic_overrides_name_3k_main_campaign_group_cosmetic_tag_faction_name_yizhou_4	Kingdom of Yizhou	false
campaign_group_faction_cosmetic_overrides_name_3k_main_campaign_group_cosmetic_tag_faction_name_dian_wei_hero_wood	PH	false
campaign_group_faction_cosmetic_overrides_name_3k_dlc04_campaign_group_cosmetic_tag_faction_name_lu_kang_separatists_4	Kingdom of Guiyang Separatists	false
campaign_group_faction_cosmetic_overrides_name_3k_main_campaign_group_cosmetic_tag_faction_name_gao_gan_separatists_3	Duchy of Bing Separatists	false
campaign_group_faction_cosmetic_overrides_name_3k_main_campaign_group_cosmetic_tag_faction_name_jiaozhi_separatists_3	Duchy of Jiaozhi Separatists	false
campaign_group_faction_cosmetic_overrides_name_3k_main_campaign_group_cosmetic_tag_faction_name_han_separatists_3	Duchy of Nie Separatists	false
campaign_group_faction_cosmetic_overrides_name_3k_main_campaign_group_cosmetic_tag_faction_name_hanzhong_4	Kingdom of Hanzhong	false
campaign_group_faction_cosmetic_overrides_name_3k_main_campaign_group_cosmetic_tag_faction_name_langye_3	Duchy of Langye	false
campaign_group_faction_cosmetic_overrides_name_3k_main_campaign_group_cosmetic_tag_faction_name_kong_rong_separatists_4	Kingdom of Qi Separatists	false
campaign_group_faction_cosmetic_overrides_name_3k_main_campaign_group_cosmetic_tag_faction_name_yangzhou_separatists_4	Kingdom of Huainan Separatists	false
campaign_group_faction_cosmetic_overrides_name_3k_dlc04_campaign_group_cosmetic_tag_faction_name_chu_gong_3	Duchy of Sili	false
campaign_group_faction_cosmetic_overrides_name_3k_main_campaign_group_cosmetic_tag_faction_name_ye_3	Duchy of Ye	false
campaign_group_faction_cosmetic_overrides_name_3k_main_campaign_group_cosmetic_tag_faction_name_ba_world_leader	Kingdom of Ba	false
campaign_group_faction_cosmetic_overrides_name_3k_dlc04_campaign_group_cosmetic_tag_faction_name_liu_xun_world_leader	Kingdom of Chengyang	false
campaign_group_faction_cosmetic_overrides_name_3k_main_campaign_group_cosmetic_tag_faction_name_liu_bei_3	Duchy of Shu-Han	false
campaign_group_faction_cosmetic_overrides_name_3k_dlc04_campaign_group_cosmetic_tag_faction_name_bian_zhang_world_leader	Kingdom of Zhang	false
campaign_group_faction_cosmetic_overrides_name_3k_main_campaign_group_cosmetic_tag_faction_name_changsha_separatists_world_leader	Kingdom of Changsha Separatists	false
campaign_group_faction_cosmetic_overrides_name_ep_campaign_group_faction_cosmetics_prince_of_changle_separatists	Lady of Changle Separatists	false
campaign_group_faction_cosmetic_overrides_name_3k_main_campaign_group_cosmetic_tag_faction_name_yingchuan_world_leader	Kingdom of Yingchuan	false
campaign_group_faction_cosmetic_overrides_name_3k_main_campaign_group_cosmetic_tag_faction_name_jianning_separatists_3	Duchy of Jianning Separatists	false
campaign_group_faction_cosmetic_overrides_name_3k_main_campaign_group_cosmetic_tag_faction_name_han_fu_3	Duchy of Nie	false
campaign_group_faction_cosmetic_overrides_name_3k_main_campaign_group_cosmetic_tag_faction_name_ma_teng_separatists_4	Kingdom of Liang Separatists	false
campaign_group_faction_cosmetic_overrides_name_3k_main_campaign_group_cosmetic_tag_faction_name_yingchuan_3	Duchy of Yingchuan	false
campaign_group_faction_cosmetic_overrides_name_3k_dlc07_campaign_group_cosmetic_tag_faction_name_que_jian	Que Jian	false
campaign_group_faction_cosmetic_overrides_name_3k_dlc04_campaign_group_cosmetic_tag_faction_name_chu_gong_separatists_4	Kingdom of Sili Separatists	false
campaign_group_faction_cosmetic_overrides_name_3k_main_campaign_group_cosmetic_tag_faction_name_wuling_separatists_world_leader	Kingdom of Wuling Separatists	false
campaign_group_faction_cosmetic_overrides_name_3k_main_campaign_group_cosmetic_tag_faction_name_ma_teng_4	Kingdom of Liang	false
campaign_group_faction_cosmetic_overrides_name_3k_main_campaign_group_cosmetic_tag_faction_name_wuwei_world_leader	Kingdom of Wuwei	false
campaign_group_faction_cosmetic_overrides_name_3k_main_campaign_group_cosmetic_tag_faction_name_hedong_3	Duchy of Hedong	false
campaign_group_faction_cosmetic_overrides_name_3k_main_campaign_group_cosmetic_tag_faction_name_poyang_separatists_4	Kingdom of Poyang Separatists	false
campaign_group_faction_cosmetic_overrides_name_3k_main_campaign_group_cosmetic_tag_faction_name_luoyang_separatists_4	Kingdom of Luoyang Separatists	false
campaign_group_faction_cosmetic_overrides_name_3k_main_campaign_group_cosmetic_tag_faction_name_beihai_4	Kingdom of Beihai	false
campaign_group_faction_cosmetic_overrides_name_3k_main_campaign_group_cosmetic_tag_faction_name_hepu_4	Kingdom of Hepu	false
campaign_group_faction_cosmetic_overrides_name_ep_campaign_group_faction_cosmetics_prince_of_zhongshan_separatists	Lady of Zhongshan Separatists	false
campaign_group_faction_cosmetic_overrides_name_3k_main_campaign_group_cosmetic_tag_faction_name_daijun_separatists_4	Kingdom of Daijun Separatists	false
campaign_group_faction_cosmetic_overrides_name_3k_main_campaign_group_cosmetic_tag_faction_name_fuling_separatists_world_leader	Kingdom of Fuling Separatists	false
campaign_group_faction_cosmetic_overrides_name_3k_main_campaign_group_cosmetic_tag_faction_name_gongsun_zan_3	Duchy of Yan	false
campaign_group_faction_cosmetic_overrides_name_3k_dlc05_campaign_group_cosmetic_tag_faction_name_shi_wu_separatists_3	Duchy of Nanhai Separatists	false
campaign_group_faction_cosmetic_overrides_name_3k_main_campaign_group_cosmetic_tag_faction_name_wudu_separatists_world_leader	Kingdom of Wudu Separatists	false
campaign_group_faction_cosmetic_overrides_name_3k_dlc04_campaign_group_cosmetic_tag_faction_name_lu_zhi_separatists_world_leader	Kingdom of Guangyang Separatists	false
campaign_group_faction_cosmetic_overrides_name_3k_main_campaign_group_cosmetic_tag_faction_name_zhang_chao_3	Duchy of Zhongwu	false
campaign_group_faction_cosmetic_overrides_name_3k_main_campaign_group_cosmetic_tag_faction_name_yuan_shao_world_leader	Kingdom of Song	false
campaign_group_faction_cosmetic_overrides_name_3k_main_campaign_group_cosmetic_tag_faction_name_changsha_world_leader	Kingdom of Changsha	false
campaign_group_faction_cosmetic_overrides_name_3k_main_campaign_group_cosmetic_tag_faction_name_hepu_separatists_3	Duchy of Hepu Separatists	false
campaign_group_faction_cosmetic_overrides_name_3k_main_campaign_group_cosmetic_tag_faction_name_tao_qian_4	Kingdom of Lu	false
campaign_group_faction_cosmetic_overrides_name_3k_dlc04_campaign_group_cosmetic_tag_faction_name_qiao_mao_4	Kingdom of Dong	false
campaign_group_faction_cosmetic_overrides_name_3k_main_campaign_group_cosmetic_tag_faction_name_sun_jian_hero_metal	PH	false
campaign_group_faction_cosmetic_overrides_name_3k_main_campaign_group_cosmetic_tag_faction_name_liu_biao_3	Duchy of Chu	false
campaign_group_faction_cosmetic_overrides_name_ep_campaign_group_faction_cosmetics_prince_of_runan_separatists	Lady of Ru'nan Separatists	false
campaign_group_faction_cosmetic_overrides_name_ep_campaign_group_faction_cosmetics_prince_of_zangke_separatists	Lady of Zangke Separatists	false
campaign_group_faction_cosmetic_overrides_name_3k_main_campaign_group_cosmetic_tag_faction_name_dong_separatists_world_leader	Kingdom of Zhou Separatists	false
campaign_group_faction_cosmetic_overrides_name_3k_main_campaign_group_cosmetic_tag_faction_name_beihai_3	Duchy of Beihai	false
campaign_group_faction_cosmetic_overrides_name_ep_campaign_group_faction_cosmetics_prince_of_yan_separatists	Lady of Yan Separatists	false
campaign_group_faction_cosmetic_overrides_name_3k_main_campaign_group_cosmetic_tag_faction_name_poyang_4	Kingdom of Poyang	false
campaign_group_faction_cosmetic_overrides_name_3k_dlc04_campaign_group_cosmetic_tag_faction_name_yuan_yi_3	Duchy of Pei	false
campaign_group_faction_cosmetic_overrides_name_3k_main_campaign_group_cosmetic_tag_faction_name_luling_world_leader	Kingdom of Luling	false
campaign_group_faction_cosmetic_overrides_name_3k_main_campaign_group_cosmetic_tag_faction_name_han_sui_separatists_4	Kingdom of Zhai Separatists	false
campaign_group_faction_cosmetic_overrides_name_3k_main_campaign_group_cosmetic_tag_faction_name_nanyang_separatists_world_leader	Kingdom of Nanyang Separatists	false
campaign_group_faction_cosmetic_overrides_name_3k_main_campaign_group_cosmetic_tag_faction_name_taishan_world_leader	Kingdom of Lean	false
campaign_group_faction_cosmetic_overrides_name_3k_main_campaign_group_cosmetic_tag_faction_name_cangwu_separatists_4	Kingdom of Cangwu Separatists	false
campaign_group_faction_cosmetic_overrides_name_3k_main_campaign_group_cosmetic_tag_faction_name_cai_mao_separatists_3	Duchy of Cai Separatists	false
campaign_group_faction_cosmetic_overrides_name_3k_main_campaign_group_cosmetic_tag_faction_name_wang_lang_separatists_3	Duchy of Tan Separatists	false
campaign_group_faction_cosmetic_overrides_name_3k_main_campaign_group_cosmetic_tag_faction_name_wuwei_separatists_4	Kingdom of Wuwei Separatists	false
campaign_group_faction_cosmetic_overrides_name_3k_dlc04_campaign_group_cosmetic_tag_faction_name_ying_shao_separatists_4	Kingdom of Xiapi Separatists	false
campaign_group_faction_cosmetic_overrides_name_3k_dlc04_campaign_group_cosmetic_tag_faction_name_xin_xuan_world_leader	Kingdom of Jing	false
campaign_group_faction_cosmetic_overrides_name_3k_main_campaign_group_cosmetic_tag_faction_name_donglai_world_leader	Kingdom of Donglai	false
campaign_group_faction_cosmetic_overrides_name_ep_campaign_group_faction_cosmetics_prince_of_jiangyang	Lady of Jiangyang	false
campaign_group_faction_cosmetic_overrides_name_3k_dlc05_campaign_group_cosmetic_tag_faction_name_sun_ce_separatists_3		false
campaign_group_faction_cosmetic_overrides_name_3k_main_campaign_group_cosmetic_tag_faction_name_taishan_separatists_4	Kingdom of Lean Separatists	false
campaign_group_faction_cosmetic_overrides_name_3k_main_campaign_group_cosmetic_tag_faction_name_nanhai_world_leader	Kingdom of Nanhai	false
campaign_group_faction_cosmetic_overrides_name_3k_main_campaign_group_cosmetic_tag_faction_name_ma_teng_separatists_world_leader	Kingdom of Liang Separatists	false
campaign_group_faction_cosmetic_overrides_name_3k_main_campaign_group_cosmetic_tag_faction_name_ma_chao_hero_fire	PH	false
campaign_group_faction_cosmetic_overrides_name_3k_main_campaign_group_cosmetic_tag_faction_name_dongou_separatists_world_leader	Kingdom of Linhai Separatists	false
campaign_group_faction_cosmetic_overrides_name_3k_dlc04_campaign_group_cosmetic_tag_faction_name_qiao_mao_separatists_3	Duchy of Dong Separatists	false
campaign_group_faction_cosmetic_overrides_name_3k_main_campaign_group_cosmetic_tag_faction_name_jiangxia_3	Duchy of Jiangxia	false
campaign_group_faction_cosmetic_overrides_name_ep_campaign_group_faction_cosmetics_prince_of_ye	Lady of Ye	false
campaign_group_faction_cosmetic_overrides_name_3k_dlc04_campaign_group_cosmetic_tag_faction_name_cao_song_4	Kingdom of Yang	false
campaign_group_faction_cosmetic_overrides_name_3k_main_campaign_group_cosmetic_tag_faction_name_zhai_rong_3	Duchy of Chao	false
campaign_group_faction_cosmetic_overrides_name_3k_main_campaign_group_cosmetic_tag_faction_name_zhai_rong_separatists_world_leader	Kingdom of Chao Separatists	false
campaign_group_faction_cosmetic_overrides_name_3k_main_campaign_group_cosmetic_tag_faction_name_jiangxia_4	Kingdom of Jiangxia	false
campaign_group_faction_cosmetic_overrides_name_3k_main_campaign_group_cosmetic_tag_faction_name_jincheng_separatists_4	Kingdom of Jincheng Separatists	false
campaign_group_faction_cosmetic_overrides_name_3k_dlc05_campaign_group_cosmetic_tag_faction_name_zang_ba_separatists_3	Duchy of Lu Separatists	false
campaign_group_faction_cosmetic_overrides_name_3k_main_campaign_group_cosmetic_tag_yellow_turban	Yellow Turban Rebellion	false
campaign_group_faction_cosmetic_overrides_name_3k_dlc04_campaign_group_cosmetic_tag_faction_name_chen_gui_separatists_world_leader	Kingdom of Qing Separatists	false
campaign_group_faction_cosmetic_overrides_name_3k_main_campaign_group_cosmetic_tag_faction_name_badong_world_leader	Kingdom of Badong	false
campaign_group_faction_cosmetic_overrides_name_3k_main_campaign_group_cosmetic_tag_faction_name_gongsun_separatists_world_leader	Kingdom of Yan Separatists	false
campaign_group_faction_cosmetic_overrides_name_ep_campaign_group_faction_cosmetics_prince_of_zangke	Lady of Zangke	false
campaign_group_faction_cosmetic_overrides_name_3k_main_campaign_group_cosmetic_tag_faction_name_hanzhong_separatists_world_leader	Kingdom of Hanzhong Separatists	false
campaign_group_faction_cosmetic_overrides_name_3k_dlc05_campaign_group_cosmetic_tag_faction_name_hua_xin_3	Duchy of Huainan	false
campaign_group_faction_cosmetic_overrides_name_3k_main_campaign_group_cosmetic_tag_faction_name_shi_separatists_world_leader	Kingdom of Jiuzhen Separatists	false
campaign_group_faction_cosmetic_overrides_name_3k_main_campaign_group_cosmetic_tag_faction_name_anding_world_leader	Kingdom of Anding	false
campaign_group_faction_cosmetic_overrides_name_3k_dlc04_campaign_group_cosmetic_tag_faction_name_wang_rui_world_leader	Kingdom of Xu	false
campaign_group_faction_cosmetic_overrides_name_3k_main_campaign_group_cosmetic_tag_faction_name_yuzhang_separatists_world_leader	Kingdom of Yuzhang Separatists	false
campaign_group_faction_cosmetic_overrides_name_3k_main_campaign_group_cosmetic_tag_faction_name_yulin_separatists_world_leader	Kingdom of Yulin Separatists	false
campaign_group_faction_cosmetic_overrides_name_3k_main_campaign_group_cosmetic_tag_faction_name_sun_separatists_4	Kingdom of Wu Separatists	false
campaign_group_faction_cosmetic_overrides_name_ep_campaign_group_faction_cosmetics_prince_of_yizhou_separatists	Lady of Yizhou Separatists	false
campaign_group_faction_cosmetic_overrides_name_3k_main_campaign_group_cosmetic_tag_faction_name_wang_kuang_separatists_4	Kingdom of Wang Separatists	false
campaign_group_faction_cosmetic_overrides_name_3k_main_campaign_group_cosmetic_tag_faction_name_liu_bei_separatists_4	Kingdom of Shu-Han Separatists	false
campaign_group_faction_cosmetic_overrides_name_3k_main_campaign_group_cosmetic_tag_faction_name_xindu_4	Kingdom of Xindu	false
campaign_group_faction_cosmetic_overrides_name_3k_main_campaign_group_cosmetic_tag_faction_name_dongjun_3	Duchy of Dongjun	false
campaign_group_faction_cosmetic_overrides_name_ep_campaign_group_faction_cosmetics_prince_of_jianan	Lady of Jian’an	false
campaign_group_faction_cosmetic_overrides_name_3k_main_campaign_group_cosmetic_tag_faction_name_zheng_jiang_3	Tai Brotherhood	false
campaign_group_faction_cosmetic_overrides_name_3k_main_campaign_group_cosmetic_tag_faction_name_badong_separatists_4	Kingdom of Badong Separatists	false
campaign_group_faction_cosmetic_overrides_name_ep_campaign_group_faction_cosmetics_prince_of_lingling_separatists	Lady of Lingling Separatists	false
campaign_group_faction_cosmetic_overrides_name_3k_main_campaign_group_cosmetic_tag_faction_name_liu_dai_separatists_world_leader	Kingdom of Tang Separatists	false
campaign_group_faction_cosmetic_overrides_name_3k_dlc04_campaign_group_cosmetic_tag_faction_name_ying_shao_4	Kingdom of Xiapi	false
campaign_group_faction_cosmetic_overrides_name_3k_dlc04_campaign_group_cosmetic_tag_faction_name_xin_xuan_4	Kingdom of Jing	false
campaign_group_faction_cosmetic_overrides_name_3k_main_campaign_group_cosmetic_tag_faction_name_chen_3	Duchy of Chenjun	false
campaign_group_faction_cosmetic_overrides_name_ep_campaign_group_faction_cosmetics_prince_of_ba	Lady of Ba	false
campaign_group_faction_cosmetic_overrides_name_3k_main_campaign_group_cosmetic_tag_faction_name_jianye_4	Kingdom of Danyang	false
campaign_group_faction_cosmetic_overrides_name_3k_dlc04_campaign_group_cosmetic_tag_faction_name_dong_he_separatists_world_leader	Kingdom of Yi Separatists	false
campaign_group_faction_cosmetic_overrides_name_ep_campaign_group_faction_cosmetics_prince_of_qin	Lady of Qin	false
campaign_group_faction_cosmetic_overrides_name_3k_dlc04_campaign_group_cosmetic_tag_faction_name_chu_gong_4	Kingdom of Sili	false
campaign_group_faction_cosmetic_overrides_name_3k_main_campaign_group_cosmetic_tag_faction_name_zhai_rong_4	Kingdom of Chao	false
campaign_group_faction_cosmetic_overrides_name_3k_main_campaign_group_cosmetic_tag_faction_name_xindu_separatists_4	Kingdom of Xindu Separatists	false
campaign_group_faction_cosmetic_overrides_name_3k_main_campaign_group_cosmetic_tag_faction_name_zhang_yan_separatists_3	Duchy of Heishan Separatists	false
campaign_group_faction_cosmetic_overrides_name_3k_main_campaign_group_cosmetic_tag_faction_name_xiahou_dun_hero_wood	PH	false
campaign_group_faction_cosmetic_overrides_name_3k_dlc04_campaign_group_cosmetic_tag_faction_name_yuan_yi_world_leader	Kingdom of Pei	false
campaign_group_faction_cosmetic_overrides_name_3k_main_campaign_group_cosmetic_tag_faction_name_shoufang_world_leader	Kingdom of Shuofang	false
campaign_group_faction_cosmetic_overrides_name_3k_dlc04_campaign_group_cosmetic_tag_faction_name_ding_yuan_4	Kingdom of Bing	false
campaign_group_faction_cosmetic_overrides_name_3k_main_campaign_group_cosmetic_tag_faction_name_liu_yao_world_leader	Kingdom of Yue	false
campaign_group_faction_cosmetic_overrides_name_3k_main_campaign_group_cosmetic_tag_faction_name_luoyang_separatists_3	Duchy of Luoyang Separatists	false
campaign_group_faction_cosmetic_overrides_name_3k_main_campaign_group_cosmetic_tag_faction_name_zhang_yan_separatists_4	Kingdom of Heishan Separatists	false
campaign_group_faction_cosmetic_overrides_name_3k_main_campaign_group_cosmetic_tag_faction_name_donghai_separatists_world_leader	Kingdom of Donghai Separatists	false
campaign_group_faction_cosmetic_overrides_name_ep_campaign_group_faction_cosmetics_prince_of_longxi_separatists	Lady of Longxi Separatists	false
campaign_group_faction_cosmetic_overrides_name_3k_main_campaign_group_cosmetic_tag_faction_name_tao_qian_3	Duchy of Lu	false
campaign_group_faction_cosmetic_overrides_name_ep_campaign_group_faction_cosmetics_prince_of_jiangxia	Lady of Jiangxia	false
campaign_group_faction_cosmetic_overrides_name_ep_campaign_group_faction_cosmetics_prince_of_wuling	Lady of Wuling	false
campaign_group_faction_cosmetic_overrides_name_3k_main_campaign_group_cosmetic_tag_faction_name_fuling_3	Duchy of Fuling	false
campaign_group_faction_cosmetic_overrides_name_3k_main_campaign_group_cosmetic_tag_faction_name_lujiang_separatists_3	Duchy of Lujiang Separatists	false
campaign_group_faction_cosmetic_overrides_name_3k_main_campaign_group_cosmetic_tag_faction_name_chen_separatists_3	Duchy of Chenjun Separatists	false
campaign_group_faction_cosmetic_overrides_name_3k_main_campaign_group_cosmetic_tag_faction_name_yuzhang_world_leader	Kingdom of Yuzhang	false
campaign_group_faction_cosmetic_overrides_name_ep_campaign_group_faction_cosmetics_prince_of_fanyang	Lady of Fanyang	false
campaign_group_faction_cosmetic_overrides_name_3k_main_campaign_group_cosmetic_tag_faction_name_lingling_separatists_4	Kingdom of Lingling Separatists	false
campaign_group_faction_cosmetic_overrides_name_3k_main_campaign_group_cosmetic_tag_faction_name_xindu_separatists_world_leader	Kingdom of Xindu Separatists	false
campaign_group_faction_cosmetic_overrides_name_ep_campaign_group_faction_cosmetics_prince_of_piling_separatists	Lady of Piling Separatists	false
campaign_group_faction_cosmetic_overrides_name_3k_main_campaign_group_cosmetic_tag_faction_name_jiangyang_separatists_world_leader	Kingdom of Jiangyang Separatists	false
campaign_group_faction_cosmetic_overrides_name_3k_main_campaign_group_cosmetic_tag_faction_name_beihai_separatists_3	Duchy of Beihai Separatists	false
campaign_group_faction_cosmetic_overrides_name_3k_main_campaign_group_cosmetic_tag_faction_name_sun_jian_4	Kingdom of Wu	false
campaign_group_faction_cosmetic_overrides_name_ep_campaign_group_faction_cosmetics_prince_of_henei_separatists	Lady of Henei Separatists	false
campaign_group_faction_cosmetic_overrides_name_3k_main_campaign_group_cosmetic_tag_faction_name_chengdu_3	Duchy of Shu	false
campaign_group_faction_cosmetic_overrides_name_3k_main_campaign_group_cosmetic_tag_faction_name_kuaiji_4	Kingdom of Kuaiji	false
campaign_group_faction_cosmetic_overrides_name_3k_dlc04_campaign_group_cosmetic_tag_faction_name_bian_zhang_separatists_world_leader	Kingdom of Zhang Separatists	false
campaign_group_faction_cosmetic_overrides_name_3k_main_campaign_group_cosmetic_tag_faction_name_changan_world_leader	Kingdom of Jingzhao	false
campaign_group_faction_cosmetic_overrides_name_3k_main_campaign_group_cosmetic_tag_faction_name_yulin_separatists_4	Kingdom of Yulin Separatists	false
campaign_group_faction_cosmetic_overrides_name_3k_main_campaign_group_cosmetic_tag_faction_name_jianan_4	Kingdom of Jian'an	false
campaign_group_faction_cosmetic_overrides_name_3k_main_campaign_group_cosmetic_tag_faction_name_yizhou_separatists_3	Duchy of Yizhou Separatists	false
campaign_group_faction_cosmetic_overrides_name_3k_main_campaign_group_cosmetic_tag_faction_name_yuzhang_separatists_4	Kingdom of Yuzhang Separatists	false
campaign_group_faction_cosmetic_overrides_name_3k_main_campaign_group_cosmetic_tag_faction_name_anping_4	Kingdom of Anping	false
campaign_group_faction_cosmetic_overrides_name_3k_main_campaign_group_cosmetic_tag_faction_name_chen_separatists_4	Kingdom of Chenjun Separatists	false
campaign_group_faction_cosmetic_overrides_name_3k_main_campaign_group_cosmetic_tag_faction_name_taishan_separatists_3	Duchy of Lean Separatists	false
campaign_group_faction_cosmetic_overrides_name_3k_main_campaign_group_cosmetic_tag_faction_name_penchang_separatists_4	Kingdom of Pengcheng Separatists	false
campaign_group_faction_cosmetic_overrides_name_3k_main_campaign_group_cosmetic_tag_faction_name_jingzhou_separatists_4	Kingdom of Jingzhou Separatists	false
campaign_group_faction_cosmetic_overrides_name_3k_main_campaign_group_cosmetic_tag_faction_name_jiaozhi_world_leader	Kingdom of Jiaozhi	false
campaign_group_faction_cosmetic_overrides_name_3k_dlc05_campaign_group_cosmetic_tag_faction_name_xue_li_separatists_4	Kingdom of Zhongli Separatists	false
campaign_group_faction_cosmetic_overrides_name_3k_dlc04_campaign_group_cosmetic_tag_faction_name_zhou_xin_separatists_3	Duchy of Jiujiang Separatists	false
campaign_group_faction_cosmetic_overrides_name_3k_main_campaign_group_cosmetic_tag_faction_name_tong'an_4	Kingdom of Tong'an	false
campaign_group_faction_cosmetic_overrides_name_3k_main_campaign_group_cosmetic_tag_faction_name_lu_bu_hero_fire	PH	false
campaign_group_faction_cosmetic_overrides_name_3k_main_campaign_group_cosmetic_tag_faction_name_wang_lang_separatists_world_leader	Kingdom of Tan Separatists	false
campaign_group_faction_cosmetic_overrides_name_ep_campaign_group_faction_cosmetics_prince_of_xinye_separatists	Lady of Xinye Separatists	false
campaign_group_faction_cosmetic_overrides_name_3k_dlc05_campaign_group_cosmetic_tag_faction_name_white_tiger_yan_separatists_4	Kingdom of Yue Separatists	false
campaign_group_faction_cosmetic_overrides_name_3k_main_campaign_group_cosmetic_tag_faction_name_cao_separatists_3	Duchy of Wei Separatists	false
campaign_group_faction_cosmetic_overrides_name_3k_main_campaign_group_cosmetic_tag_faction_name_shangyong_world_leader	Kingdom of Shangyong	false
campaign_group_faction_cosmetic_overrides_name_3k_main_campaign_group_cosmetic_tag_faction_name_dongjun_world_leader	Kingdom of Dongjun	false
campaign_group_faction_cosmetic_overrides_name_3k_main_campaign_group_cosmetic_tag_faction_name_bohai_4	Kingdom of Bohai	false
campaign_group_faction_cosmetic_overrides_name_3k_main_campaign_group_cosmetic_tag_faction_name_cai_mao_3	Duchy of Cai	false
campaign_group_faction_cosmetic_overrides_name_3k_dlc04_campaign_group_cosmetic_tag_faction_name_liang_rebels_world_leader	Kingdom of Longxi	false
campaign_group_faction_cosmetic_overrides_name_3k_dlc05_campaign_group_cosmetic_tag_faction_name_wu_jing_separatists_3	Duchy of Xu Separatists	false
campaign_group_faction_cosmetic_overrides_name_3k_dlc05_campaign_group_cosmetic_tag_faction_name_shi_yi_4	Kingdom of Hepu	false
campaign_group_faction_cosmetic_overrides_name_3k_main_campaign_group_cosmetic_tag_faction_name_kuaiji_world_leader	Kingdom of Kuaiji	false
campaign_group_faction_cosmetic_overrides_name_3k_main_campaign_group_cosmetic_tag_faction_name_kong_rong_4	Kingdom of Qi	false
campaign_group_faction_cosmetic_overrides_name_3k_main_campaign_group_cosmetic_tag_faction_name_liaodong_world_leader	Kingdom of Liaodong	false
campaign_group_faction_cosmetic_overrides_name_3k_main_campaign_group_cosmetic_tag_faction_name_rebels_world_leader	Kingdom of Rebels	false
campaign_group_faction_cosmetic_overrides_name_3k_dlc04_campaign_group_cosmetic_tag_faction_name_dong_he_separatists_4	Kingdom of Yi Separatists	false
campaign_group_faction_cosmetic_overrides_name_3k_main_campaign_group_cosmetic_tag_faction_name_luling_separatists_4	Kingdom of Luling Separatists	false
campaign_group_faction_cosmetic_overrides_name_3k_dlc05_campaign_group_cosmetic_tag_faction_name_white_tiger_yan_world_leader	Kingdom of Yue	false
campaign_group_faction_cosmetic_overrides_name_3k_main_campaign_group_cosmetic_tag_faction_name_liu_bei_4	Kingdom of Shu-Han	false
campaign_group_faction_cosmetic_overrides_name_3k_main_campaign_group_cosmetic_tag_faction_name_liu_biao_world_leader	Kingdom of Chu	false
campaign_group_faction_cosmetic_overrides_name_3k_main_campaign_group_cosmetic_tag_faction_name_zheng_jiang_separatists_3	Tai Brotherhood Separatists	false
campaign_group_faction_cosmetic_overrides_name_3k_main_campaign_group_cosmetic_tag_faction_name_youbeiping_separatists_3	Duchy of Youbeiping Separatists	false
campaign_group_faction_cosmetic_overrides_name_3k_dlc05_campaign_group_cosmetic_tag_faction_name_zhu_fu_separatists_4	Kingdom of Kui Separatists	false
campaign_group_faction_cosmetic_overrides_name_3k_main_campaign_group_cosmetic_tag_faction_name_ba_separatists_world_leader	Kingdom of Ba Separatists	false
