key	text	tooltip
#Loc;1;text/db/pooled_resource_factors__.loc		
pooled_resource_factors_display_name_positive_3k_main_pooled_factor_population_conscription	Conscription	false
pooled_resource_factors_display_name_negative_3k_dlc07_pooled_factor_lineage_captains_employed	Captains employed	false
pooled_resource_factors_display_name_negative_3k_dlc05_pooled_factor_white_tiger_confederation_diplomacy	Diplomatic treaties	false
pooled_resource_factors_display_name_negative_3k_main_pooled_factor_annexation_currency_gain	HIDDEN	false
pooled_resource_factors_display_name_negative_3k_main_pooled_factor_credibility	Credibility lost	false
pooled_resource_factors_display_name_positive_3k_main_pooled_factor_population_characters_people_in_power	People in power	false
pooled_resource_factors_display_name_negative_3k_dlc05_pooled_factor_shared_expertise_from_characters	Shared expertise gained from characters	false
pooled_resource_factors_display_name_negative_ep_pooled_factor_subterfuge_buildings	Subterfuge	false
pooled_resource_factors_display_name_negative_3k_main_pooled_factor_food_assignments	Assignments	false
pooled_resource_factors_display_name_negative_3k_main_pooled_factor_intimidation_assignments	Assignments	false
pooled_resource_factors_display_name_negative_ep_pooled_factor_reformation_assignments	Assignments	false
pooled_resource_factors_display_name_negative_3k_dlc06_pooled_factor_resource_goddess_of_fire_seasons	Goddess of Fire from seasons	false
pooled_resource_factors_display_name_negative_3k_main_pooled_factor_population_characters_administrators	{{tr:Governors}}	false
pooled_resource_factors_display_name_negative_3k_dlc05_pooled_factor_shared_expertise_from_court_actions	Expertise spent from court actions	false
pooled_resource_factors_display_name_positive_3k_dlc05_pooled_factor_mercenary_activity_battles	Victories	false
pooled_resource_factors_display_name_negative_3k_main_pooled_factor_food_from_foraging	Foraging	false
pooled_resource_factors_display_name_positive_3k_dlc04_pooled_factor_bureaucrats_influence	Bureaucracy influence increase	false
pooled_resource_factors_display_name_positive_3k_dlc07_pooled_factor_lineage_battles_won	Battles won	false
pooled_resource_factors_display_name_negative_3k_dlc04_pooled_factor_political_influence_from_buildings	Buildings	false
pooled_resource_factors_display_name_positive_3k_dlc05_pooled_factor_supply_from_stances	Resupplying	false
pooled_resource_factors_display_name_negative_3k_main_pooled_factor_infamy	Infamy lost	false
pooled_resource_factors_display_name_positive_ep_pooled_factor_control_buildings	Buildings	false
pooled_resource_factors_display_name_positive_3k_dlc04_pooled_factor_fervour_regional	{{tr:dlc04_term_regional_fervour}}	false
pooled_resource_factors_display_name_positive_3k_main_pooled_factor_population_public_order	{{tr:Public_order}}	false
pooled_resource_factors_display_name_positive_ep_pooled_factor_influence_diplomacy	Influence	false
pooled_resource_factors_display_name_negative_ep_pooled_factor_control_buildings	Control	false
pooled_resource_factors_display_name_positive_ep_pooled_factor_influence_decay	Decay	false
pooled_resource_factors_display_name_negative_3k_dlc07_pooled_factor_imperial_favour_post_battle	Military Atrocities	false
pooled_resource_factors_display_name_negative_3k_dlc04_pooled_factor_fervour_regional_assignments	Assignments	false
pooled_resource_factors_display_name_negative_3k_main_pooled_factor_credibility_faction_rank	Faction rank	false
pooled_resource_factors_display_name_negative_3k_main_pooled_factor_food_sacking	Sacking	false
pooled_resource_factors_display_name_negative_3k_dlc04_factor_domain_regions	Overextended domain	false
pooled_resource_factors_display_name_negative_3k_main_pooled_factor_population_characters_people_in_power	People in power	false
pooled_resource_factors_display_name_negative_3k_main_pooled_factor_intimidation	Intimidation lost	false
pooled_resource_factors_display_name_positive_3k_dlc07_pooled_factor_imperial_favour_characters_people_in_power	Faction Leader Rank	false
pooled_resource_factors_display_name_negative_3k_dlc07_pooled_factor_imperial_favour_public_order	Public Order 	false
pooled_resource_factors_display_name_negative_3k_main_pooled_factor_food	Food consumption	false
pooled_resource_factors_display_name_positive_ep_pooled_factor_jurisdiction_vassals	Vassals	false
pooled_resource_factors_display_name_negative_3k_dlc07_pooled_factor_imperial_favour_food	Food Shortage	false
pooled_resource_factors_display_name_positive_3k_dlc05_pooled_factor_momentum_settlements_razed	Settlements razed	false
pooled_resource_factors_display_name_positive_3k_dlc04_pooled_factor_political_influence_from_bureaucracy_power_level	Bureaucrat empowerment	false
pooled_resource_factors_display_name_positive_3k_main_pooled_factor_heroism_events	Events	false
pooled_resource_factors_display_name_positive_3k_main_pooled_factor_intimidation_from_battles	Victories	false
pooled_resource_factors_display_name_negative_ep_pooled_factor_fist_alignment	From events	false
pooled_resource_factors_display_name_positive_3k_dlc07_pooled_factor_imperial_favour	Imperial Favour	false
pooled_resource_factors_display_name_positive_ep_pooled_factor_sima_wei_gifts	Gifts	false
pooled_resource_factors_display_name_negative_3k_dlc06_pooled_factor_splendour_faction_leaders	Family Member Faction Leaders	false
pooled_resource_factors_display_name_positive_3k_main_pooled_factor_supply_from_military_buildings	Military infrastructure	false
pooled_resource_factors_display_name_positive_3k_main_pooled_factor_infamy_from_occupations	Occupation	false
pooled_resource_factors_display_name_positive_3k_main_pooled_factor_legitimacy	Increase	false
pooled_resource_factors_display_name_negative_3k_dlc04_pooled_factor_dynasty_influence	Imperial dynasty influence decrease	false
pooled_resource_factors_display_name_negative_3k_dlc05_pooled_factor_mercenary_activity_decay	Decay	false
pooled_resource_factors_display_name_negative_3k_main_pooled_factor_food_local_farming	Farming	false
pooled_resource_factors_display_name_positive_3k_main_pooled_factor_trade_monopoly	Trade extortion	false
pooled_resource_factors_display_name_negative_ep_pooled_factor_jurisdiction_buildings	Buildings	false
pooled_resource_factors_display_name_negative_3k_dlc05_pooled_factor_reckless_luck_decay	Reckless Luck Decay rate	false
pooled_resource_factors_display_name_positive_3k_main_pooled_factor_food_fishing	Fishing	false
pooled_resource_factors_display_name_positive_3k_dlc07_pooled_factor_imperial_favour_post_battle	Military Feats	false
pooled_resource_factors_display_name_positive_3k_main_pooled_factor_credibility_faction_rank	Faction rank	false
pooled_resource_factors_display_name_positive_3k_main_pooled_factor_lineage_allies	Lineage from allies	false
pooled_resource_factors_display_name_negative_3k_dlc04_pooled_factor_political_influence_from_assignments	Assignments	false
pooled_resource_factors_display_name_negative_3k_main_pooled_factor_satisfaction	Low satisfaction	false
pooled_resource_factors_display_name_negative_3k_dlc04_factor_domain_buildings	Buildings	false
pooled_resource_factors_display_name_negative_3k_dlc04_pooled_factor_fortitude	Fortitude lost	false
pooled_resource_factors_display_name_positive_3k_dlc05_pooled_factor_mercenary_activity	Fame & Fortune Increase	false
pooled_resource_factors_display_name_positive_3k_main_pooled_factor_population_migration	Migration	false
pooled_resource_factors_display_name_negative_3k_main_pooled_factor_heroism_from_military_feats	Heroism lost through military blunders	false
pooled_resource_factors_display_name_negative_3k_main_pooled_factor_food_fishing	Fishing	false
pooled_resource_factors_display_name_positive_3k_dlc04_pooled_factor_political_influence_from_buildings	Buildings	false
pooled_resource_factors_display_name_positive_3k_dlc04_pooled_factor_fervour_regional_decay	Increase	false
pooled_resource_factors_display_name_negative_3k_dlc06_pooled_factor_resource_smouldering_fire_increase	Smouldering Fire decay rate	false
pooled_resource_factors_display_name_positive_3k_dlc05_pooled_factor_white_tiger_confederation	Confederation expands	false
pooled_resource_factors_display_name_positive_3k_main_pooled_factor_population_assignment	Assignments	false
pooled_resource_factors_display_name_positive_3k_dlc04_pooled_factor_fervour_regional_buildings	Buildings	false
pooled_resource_factors_display_name_negative_3k_main_pooled_factor_unity_from_annexation	Integration of settlements	false
pooled_resource_factors_display_name_negative_3k_dlc07_pooled_factor_imperial_favour_intimidation	Intimidation	false
pooled_resource_factors_display_name_negative_3k_dlc04_pooled_factor_warlords_influence_from_events	Events	false
pooled_resource_factors_display_name_positive_3k_dlc04_pooled_factor_warlords_influence_from_court_positions	Court positions	false
pooled_resource_factors_display_name_negative_3k_dlc04_pooled_factor_fervour_regional_adjacent	Neighbouring {{tr:map_regions}}	false
pooled_resource_factors_display_name_positive_3k_main_pooled_factor_supply_from_food	Food balance	false
pooled_resource_factors_display_name_negative_3k_main_pooled_factor_intimidation_decay	Decline	false
pooled_resource_factors_display_name_positive_3k_main_pooled_factor_population_post_siege	Sieges	false
pooled_resource_factors_display_name_negative_ep_pooled_factor_heart_alignment	From events	false
pooled_resource_factors_display_name_negative_3k_dlc06_pooled_factor_splendour_tribute_chests	Tribute Chests Created	false
pooled_resource_factors_display_name_negative_3k_dlc04_pooled_factor_fervour_regional_buildings	Buildings	false
pooled_resource_factors_display_name_positive_3k_dlc05_pooled_factor_mercenary_activity_events	Events	false
pooled_resource_factors_display_name_negative_3k_dlc07_pooled_factor_lineage_wars_declared	Wars declared	false
pooled_resource_factors_display_name_positive_3k_main_pooled_factor_supply_from_assignments	Assignments	false
pooled_resource_factors_display_name_negative_3k_dlc05_pooled_factor_momentum_assignments	Assignments	false
pooled_resource_factors_display_name_negative_3k_main_pooled_factor_intimidation_diplomacy	Diplomacy	false
pooled_resource_factors_display_name_negative_3k_dlc04_pooled_factor_political_influence_decrease_from_expenditure	Expenditure	false
pooled_resource_factors_display_name_positive_3k_dlc04_pooled_factor_bureaucrats_influence_from_court_positions	Court positions	false
pooled_resource_factors_display_name_positive_ep_pooled_factor_jurisdiction_buildings	Buildings	false
pooled_resource_factors_display_name_positive_3k_dlc06_pooled_factor_resource_goddess_of_fire_seasons	Goddess of Fire from seasons	false
pooled_resource_factors_display_name_negative_3k_dlc04_pooled_factor_bureaucrats_influence	Bureaucracy influence decrease	false
pooled_resource_factors_display_name_negative_3k_dlc04_pooled_factor_governance_buildings	Buildings	false
pooled_resource_factors_display_name_positive_3k_dlc04_pooled_factor_fortitude_from_military_feats	Fortitude gained through personal victory	false
pooled_resource_factors_display_name_negative_3k_dlc07_pooled_factor_imperial_favour_enemy_of_the_han	Treaties with an Enemy of the Han	false
pooled_resource_factors_display_name_negative_3k_dlc05_pooled_factor_mercenary_activity_battles	Defeats	false
pooled_resource_factors_display_name_positive_3k_dlc05_pooled_factor_momentum_character_actions	Court actions	false
pooled_resource_factors_display_name_negative_ep_pooled_factor_influence_battles	Defeats	false
pooled_resource_factors_display_name_positive_3k_dlc04_pooled_factor_fervour_regional_assignments	Assignments	false
pooled_resource_factors_display_name_negative_ep_pooled_factor_influence_diplomacy	Influence expended in diplomacy	false
pooled_resource_factors_display_name_positive_3k_main_pooled_factor_lineage_siege_options	Occupation options	false
pooled_resource_factors_display_name_negative_3k_main_pooled_factor_supply_farming	Farming	false
pooled_resource_factors_display_name_positive_3k_dlc07_pooled_factor_ambition_conquest	Aspiration from conquest	false
pooled_resource_factors_display_name_positive_3k_dlc04_factor_domain	Domain increased	false
pooled_resource_factors_display_name_negative_3k_dlc05_pooled_factor_supply_from_stances	Raiding	false
pooled_resource_factors_display_name_negative_3k_main_pooled_factor_legitimacy	Decrease	false
pooled_resource_factors_display_name_negative_3k_dlc04_pooled_factor_bureaucrats_influence_from_events	Events	false
pooled_resource_factors_display_name_positive_3k_dlc04_pooled_factor_bureaucrats_influence_from_events	Events	false
pooled_resource_factors_display_name_negative_ep_pooled_factor_control_recruitment	Recruitment	false
pooled_resource_factors_display_name_negative_ep_pooled_factor_subterfuge_spies_2	Subterfuge	false
pooled_resource_factors_display_name_positive_3k_main_pooled_factor_food_sacking	Sacking	false
pooled_resource_factors_display_name_negative_3k_dlc07_pooled_factor_food_prestige	Prestige	false
pooled_resource_factors_display_name_negative_3k_main_pooled_factor_intimidation_razed_settlements	Razing & sacking	false
pooled_resource_factors_display_name_negative_3k_main_pooled_factor_legitimacy_assignments	Assignments	false
pooled_resource_factors_display_name_positive_ep_pooled_factor_heart_alignment	From events	false
pooled_resource_factors_display_name_negative_3k_dlc06_pooled_factor_splendour_court_members_own	Court Members in Faction	false
pooled_resource_factors_display_name_negative_3k_main_pooled_factor_supply_from_characters	Characters	false
pooled_resource_factors_display_name_negative_3k_dlc04_pooled_factor_bureaucrats_influence_from_eunuchs	Eunuchs	false
pooled_resource_factors_display_name_positive_3k_main_pooled_factor_infamy_decay	Infamy growth	false
pooled_resource_factors_display_name_negative_3k_dlc04_pooled_factor_fervour_regional_decay	Decay	false
pooled_resource_factors_display_name_positive_3k_main_pooled_factor_legitimacy_buildings	Buildings	false
pooled_resource_factors_display_name_positive_3k_main_pooled_factor_unity_from_annexation	Integration of settlements	false
pooled_resource_factors_display_name_positive_3k_dlc07_pooled_factor_imperial_favour_diplomacy	Political Manoeuvring	false
pooled_resource_factors_display_name_positive_3k_main_pooled_factor_supply_from_characters	Characters	false
pooled_resource_factors_display_name_positive_3k_dlc05_pooled_factor_momentum_settlements_annexed	Settlements annexed	false
pooled_resource_factors_display_name_positive_ep_pooled_factor_control_faction_leader	Faction leader	false
pooled_resource_factors_display_name_positive_3k_dlc04_pooled_factor_governance_vassals	Vassals	false
pooled_resource_factors_display_name_positive_3k_dlc06_pooled_factor_mulu_pride	Pride earned	false
pooled_resource_factors_display_name_negative_ep_pooled_factor_reformation_administrators	{{tr:Governors}}	false
pooled_resource_factors_display_name_negative_3k_dlc04_pooled_factor_displaced_population_resettlement	Resettlement efforts	false
pooled_resource_factors_display_name_negative_3k_dlc07_pooled_factor_imperial_favour_events	Events	false
pooled_resource_factors_display_name_negative_3k_dlc05_pooled_factor_food_from_banditry	Banditry	false
pooled_resource_factors_display_name_positive_3k_main_pooled_factor_food_characters	Characters	false
pooled_resource_factors_display_name_positive_ep_pooled_factor_control_battle	Control established through military feats	false
pooled_resource_factors_display_name_negative_3k_main_pooled_factor_population_overpopulation	Overpopulated	false
pooled_resource_factors_display_name_positive_3k_dlc04_pooled_factor_fervour_regional_adjacent	Neighbouring {{tr:map_regions}}	false
pooled_resource_factors_display_name_positive_3k_dlc07_pooled_factor_lineage_tresspassing	Tresspassing	false
pooled_resource_factors_display_name_negative_ep_pooled_factor_sima_wei_decay	Decay	false
pooled_resource_factors_display_name_negative_3k_main_pooled_factor_trade_monopoly_decay	Market forces	false
pooled_resource_factors_display_name_positive_3k_dlc04_pooled_factor_dynasty_influence_from_events	Events	false
pooled_resource_factors_display_name_negative_3k_main_pooled_factor_supply	Supply	false
pooled_resource_factors_display_name_positive_3k_dlc06_pooled_factor_shamoke_confederate	DOMINATION	false
pooled_resource_factors_display_name_negative_3k_main_pooled_factor_heroism_events	Events	false
pooled_resource_factors_display_name_positive_3k_dlc07_pooled_factor_lineage_vassals_obtained	Vassals obtained	false
pooled_resource_factors_display_name_positive_3k_dlc04_pooled_factor_political_influence_from_warlords_power_level	Warlord empowerment	false
pooled_resource_factors_display_name_positive_3k_dlc04_pooled_factor_political_influence_from_dynasty_power_level	Dynasty empowerment	false
pooled_resource_factors_display_name_negative_ep_pooled_factor_sima_wei	Fury	false
pooled_resource_factors_display_name_negative_3k_dlc04_pooled_factor_fervour	Zeal decrease	false
pooled_resource_factors_display_name_positive_3k_dlc04_pooled_factor_fervour_increase_from_military_stength	Military strength	false
pooled_resource_factors_display_name_positive_3k_main_pooled_factor_population_characters_administrators	{{tr:Governors}}	false
pooled_resource_factors_display_name_positive_3k_main_pooled_factor_lineage_recruitment	Recruitment	false
pooled_resource_factors_display_name_negative_3k_main_pooled_factor_population_hostile_forces	Hostile forces	false
pooled_resource_factors_display_name_negative_3k_main_pooled_factor_infamy_from_occupations	Occupation	false
pooled_resource_factors_display_name_negative_3k_dlc05_pooled_factor_reckless_luck_from_ambitions	Reckless Luck lost	false
pooled_resource_factors_display_name_positive_3k_main_pooled_factor_food_local_farming	Farming	false
pooled_resource_factors_display_name_positive_3k_dlc07_pooled_factor_lineage_battles_fought	Battles fought	false
pooled_resource_factors_display_name_negative_3k_main_pooled_factor_supply_post_siege	Sieges	false
pooled_resource_factors_display_name_positive_3k_dlc07_pooled_factor_lineage_northern_army_unit_employed	Northern army units	false
pooled_resource_factors_display_name_negative_ep_pooled_factor_sima_wei_assignments	Assignments	false
pooled_resource_factors_display_name_negative_ep_pooled_factor_control_remove	Removed opposition	false
pooled_resource_factors_display_name_negative_3k_main_pooled_factor_legitimacy_propaganda	Faction rank	false
pooled_resource_factors_display_name_positive_3k_dlc06_pooled_factor_splendour_court_members_own	Court Members in faction	false
pooled_resource_factors_display_name_positive_3k_main_pooled_factor_intimidation_annexation	Integrated Han Empire	false
pooled_resource_factors_display_name_positive_3k_main_pooled_factor_intimidation	Intimidation gained	false
pooled_resource_factors_display_name_negative_3k_dlc04_pooled_factor_governance	Han displeasure	false
pooled_resource_factors_display_name_negative_3k_main_pooled_factor_food_characters	Characters	false
pooled_resource_factors_display_name_positive_3k_dlc04_pooled_factor_fervour_decrease_from_decay	HIDDEN	false
pooled_resource_factors_display_name_positive_3k_dlc05_pooled_factor_shared_expertise_from_characters	Shared expertise gained from characters	false
pooled_resource_factors_display_name_negative_3k_dlc07_pooled_factor_lineage_battles_fought	Battles fought	false
pooled_resource_factors_display_name_positive_3k_main_pooled_factor_heroism	Heroism gained	false
pooled_resource_factors_display_name_negative_3k_dlc04_pooled_factor_fervour_battles	Defeats	false
pooled_resource_factors_display_name_positive_ep_pooled_factor_demesne_buildings	Buildings	false
pooled_resource_factors_display_name_negative_3k_dlc06_pooled_factor_resource_flaming_confinement_increase	Flaming Confinement decay rate	false
pooled_resource_factors_display_name_negative_3k_dlc04_pooled_factor_warlords_influence	Warlord influence decrease	false
pooled_resource_factors_display_name_positive_3k_dlc07_pooled_factor_imperial_favour_post_siege	Occupation	false
pooled_resource_factors_display_name_positive_3k_dlc05_pooled_factor_white_tiger_confederation_diplomacy	Diplomatic treaties	false
pooled_resource_factors_display_name_negative_3k_dlc07_pooled_factor_ambition_tradeoffs_tracker	HIDDEN	false
pooled_resource_factors_display_name_positive_3k_main_pooled_factor_infamy_from_tribute	Tribute earned	false
pooled_resource_factors_display_name_positive_3k_main_pooled_factor_legitimacy_diplomacy	Diplomacy	false
pooled_resource_factors_display_name_positive_3k_dlc07_pooled_factor_food_prestige	Prestige	false
pooled_resource_factors_display_name_negative_3k_dlc04_pooled_factor_fervour_increase_from_faction_support	HIDDEN	false
pooled_resource_factors_display_name_negative_ep_pooled_factor_subterfuge	Subterfuge lost	false
pooled_resource_factors_display_name_negative_ep_pooled_factor_influence_assignments	Assignments	false
pooled_resource_factors_display_name_negative_3k_main_pooled_factor_legitimacy_diplomacy	Diplomacy	false
pooled_resource_factors_display_name_negative_3k_main_pooled_factor_intimidation_promotions	Promotions	false
pooled_resource_factors_display_name_positive_3k_dlc04_pooled_factor_fervour_regional_fervour	{{tr:dlc04_term_fervour}}	false
pooled_resource_factors_display_name_negative_3k_main_pooled_factor_lineage_decay	Lineage fading	false
pooled_resource_factors_display_name_positive_ep_pooled_factor_control	Control gained	false
pooled_resource_factors_display_name_negative_3k_main_pooled_factor_food_distribution	Food distribution	false
pooled_resource_factors_display_name_positive_3k_main_pooled_factor_credibility_events	Events	false
pooled_resource_factors_display_name_positive_3k_main_pooled_factor_intimidation_promotions	Promotions	false
pooled_resource_factors_display_name_positive_3k_main_pooled_factor_food_distribution	Food distribution	false
pooled_resource_factors_display_name_positive_ep_pooled_factor_control_recruitment	Recruitment	false
pooled_resource_factors_display_name_positive_3k_dlc04_pooled_factor_warlords_influence_from_characters	Characters	false
pooled_resource_factors_display_name_positive_ep_pooled_factor_sima_wei_decay	Increase	false
pooled_resource_factors_display_name_positive_3k_main_pooled_factor_population_culture	Culture	false
pooled_resource_factors_display_name_negative_3k_main_pooled_factor_intimidation_faction_leader_death	Succession	false
pooled_resource_factors_display_name_positive_3k_main_pooled_factor_infamy_from_victories	Infamy from battle victory	false
pooled_resource_factors_display_name_positive_3k_dlc05_pooled_factor_momentum_characters_defeated	Characters defeated	false
pooled_resource_factors_display_name_positive_3k_main_pooled_factor_food_sold	Food markets	false
pooled_resource_factors_display_name_positive_3k_main_pooled_factor_supply_farming	Farming	false
pooled_resource_factors_display_name_positive_ep_pooled_factor_subterfuge	Subterfuge gained	false
pooled_resource_factors_display_name_negative_3k_dlc07_pooled_factor_lineage_northern_army_unit_employed	Northern army units	false
pooled_resource_factors_display_name_positive_3k_dlc04_pooled_factor_fervour_regional_adjacent_forces	Neighbouring {{tr:map_regions}} (forces)	false
pooled_resource_factors_display_name_negative_3k_main_pooled_factor_intimidation_events	Events	false
pooled_resource_factors_display_name_positive_3k_dlc07_pooled_factor_lineage_wars_declared	Wars declared	false
pooled_resource_factors_display_name_negative_3k_dlc07_pooled_factor_imperial_favour_credibility	Credibility	false
pooled_resource_factors_display_name_negative_3k_dlc06_pooled_factor_resource_goddess_of_fire_increase	Goddess of Fire decay rate	false
pooled_resource_factors_display_name_negative_3k_main_pooled_factor_food_diplomacy	Diplomacy	false
pooled_resource_factors_display_name_positive_ep_pooled_factor_control_assignment	Assignments	false
pooled_resource_factors_display_name_positive_ep_pooled_factor_subterfuge_spies_2	Underhanded spy activity	false
pooled_resource_factors_display_name_positive_3k_dlc06_pooled_factor_mulu_pride_from_rituals	Pride from known rituals	false
pooled_resource_factors_display_name_negative_ep_pooled_factor_demesne_buildings	Buildings	false
pooled_resource_factors_display_name_positive_3k_main_pooled_factor_population_buildings	Infrastructure	false
pooled_resource_factors_display_name_positive_3k_dlc06_pooled_factor_resource_smouldering_fire_increase	Smouldering Fire gain rate	false
pooled_resource_factors_display_name_negative_3k_dlc04_pooled_factor_dynasty_influence_from_events	Events	false
pooled_resource_factors_display_name_negative_3k_dlc07_pooled_factor_lineage_vassals_obtained	Vassals obtained	false
pooled_resource_factors_display_name_negative_3k_main_pooled_factor_unity_from_post_battle	Losing armies	false
pooled_resource_factors_display_name_negative_3k_main_pooled_factor_trade_monopoly	Trade extortion	false
pooled_resource_factors_display_name_positive_3k_main_pooled_factor_heroism_decay	Heroism decay rate	false
pooled_resource_factors_display_name_negative_3k_dlc04_pooled_factor_fervour_regional_adjacent_forces	Neighbouring {{tr:map_regions}} (forces)	false
pooled_resource_factors_display_name_negative_3k_dlc05_pooled_factor_momentum_diplomacy	Diplomatic Coercion	false
pooled_resource_factors_display_name_positive_3k_dlc04_pooled_factor_fortitude_events	Events	false
pooled_resource_factors_display_name_negative_3k_main_pooled_factor_infamy_from_victories	Infamy lost from defeat	false
pooled_resource_factors_display_name_negative_ep_pooled_factor_jurisdiction_people_in_power	People in power	false
pooled_resource_factors_display_name_positive_3k_main_pooled_factor_food	Food production	false
pooled_resource_factors_display_name_negative_3k_main_pooled_factor_population_migration	Migration	false
pooled_resource_factors_display_name_negative_3k_dlc04_pooled_factor_fortitude_decay	Fortitude decay rate	false
pooled_resource_factors_display_name_negative_3k_dlc04_pooled_factor_fortitude_from_military_feats	Fortitude gained through personal victory	false
pooled_resource_factors_display_name_positive_3k_dlc04_factor_domain_buildings	Buildings	false
pooled_resource_factors_display_name_positive_3k_dlc04_pooled_factor_governance_buildings	Buildings	false
pooled_resource_factors_display_name_positive_3k_main_pooled_factor_food_events	Events	false
pooled_resource_factors_display_name_negative_ep_pooled_factor_jurisdiction_siege	Sieges	false
pooled_resource_factors_display_name_negative_ep_pooled_factor_control_battle	Control lost through military blunders	false
pooled_resource_factors_display_name_negative_3k_main_pooled_factor_population_buildings	Infrastructure	false
pooled_resource_factors_display_name_positive_3k_dlc04_pooled_factor_bureaucrats_influence_from_eunuchs	Eunuchs	false
pooled_resource_factors_display_name_positive_3k_main_pooled_factor_lineage_buildings	Lineage from palaces	false
pooled_resource_factors_display_name_positive_3k_main_pooled_factor_population_overpopulation	Overpopulated	false
pooled_resource_factors_display_name_positive_3k_dlc07_pooled_factor_ambition_buildings	Aspiration from buildings	false
pooled_resource_factors_display_name_positive_3k_main_pooled_factor_unity_from_assignments	Assignments	false
pooled_resource_factors_display_name_negative_3k_main_pooled_factor_food_events	Events	false
pooled_resource_factors_display_name_positive_3k_dlc04_pooled_factor_political_influence_from_basic_income	Income	false
pooled_resource_factors_display_name_negative_3k_dlc07_pooled_factor_lineage_battles_won	Battles Won	false
pooled_resource_factors_display_name_positive_3k_dlc04_pooled_factor_warlords_influence	Warlord influence increase	false
pooled_resource_factors_display_name_negative_3k_dlc07_pooled_factor_ambition_spending	Aspiration spent	false
pooled_resource_factors_display_name_negative_3k_main_pooled_factor_population_assignment	Assignments	false
pooled_resource_factors_display_name_positive_3k_dlc05_pooled_factor_momentum_diplomacy	Diplomatic coercion	false
pooled_resource_factors_display_name_positive_ep_pooled_factor_subterfuge_spies_3	Nefarious spy activity	false
pooled_resource_factors_display_name_negative_3k_dlc06_pooled_factor_shamoke_confederate	DOMINATION	false
pooled_resource_factors_display_name_negative_ep_pooled_factor_money_alignment	From events	false
pooled_resource_factors_display_name_negative_3k_dlc04_pooled_factor_political_influence_from_dynasty_power_level	Dynasty empowerment	false
pooled_resource_factors_display_name_negative_ep_pooled_factor_influence_decay	Decay	false
pooled_resource_factors_display_name_positive_3k_dlc07_pooled_factor_imperial_favour_governance	Governance	false
pooled_resource_factors_display_name_positive_3k_dlc04_pooled_factor_fervour_regional_characters	Characters	false
pooled_resource_factors_display_name_negative_3k_dlc07_pooled_factor_imperial_favour_diplomacy	Political Manoeuvring	false
pooled_resource_factors_display_name_positive_3k_dlc05_pooled_factor_reckless_luck_from_ambitions	Reckless Luck gained	false
pooled_resource_factors_display_name_negative_3k_dlc05_pooled_factor_mercenary_activity_settlement_occupations	HIDDEN	false
pooled_resource_factors_display_name_positive_3k_dlc04_pooled_factor_warlords_influence_from_events	Events	false
pooled_resource_factors_display_name_negative_3k_dlc05_pooled_factor_momentum_settlements_annexed	Settlements Annexed	false
pooled_resource_factors_display_name_positive_3k_dlc04_pooled_factor_fervour_regional_events	Events	false
pooled_resource_factors_display_name_negative_3k_dlc04_pooled_factor_political_influence_from_basic_income	Income	false
pooled_resource_factors_display_name_negative_3k_main_pooled_factor_food_population	Population	false
pooled_resource_factors_display_name_negative_3k_main_pooled_factor_lineage_buildings	Lineage from palaces	false
pooled_resource_factors_display_name_positive_3k_main_pooled_factor_unity_from_post_battle	Victorious armies	false
pooled_resource_factors_display_name_negative_3k_main_pooled_factor_population_culture	Culture	false
pooled_resource_factors_display_name_positive_3k_main_pooled_factor_food_eunuchs	Eunuch policies	false
pooled_resource_factors_display_name_positive_3k_main_pooled_factor_unity_from_events	Events & missions	false
pooled_resource_factors_display_name_positive_3k_main_pooled_factor_food_population	Population	false
pooled_resource_factors_display_name_negative_3k_dlc05_pooled_factor_momentum_characters_defeated	Losses in Battle	false
pooled_resource_factors_display_name_negative_3k_dlc07_pooled_factor_imperial_favour_legitimacy	Legitimacy	false
pooled_resource_factors_display_name_negative_3k_dlc07_pooled_factor_ambition_conquest	Aspiration from conquest	false
pooled_resource_factors_display_name_negative_3k_main_pooled_factor_annexation_currency	HIDDEN	false
pooled_resource_factors_display_name_positive_3k_main_pooled_factor_intimidation_diplomacy	Diplomacy	false
pooled_resource_factors_display_name_positive_ep_pooled_factor_reformation_buildings_positive	Reformed infrastructure	false
pooled_resource_factors_display_name_positive_3k_dlc05_pooled_factor_personal_victories_characters_defeated	Characters defeated	false
pooled_resource_factors_display_name_positive_3k_main_pooled_factor_legitimacy_propaganda	Faction rank	false
pooled_resource_factors_display_name_negative_3k_dlc04_pooled_factor_displaced_population_occupation_domestic	Domestic occupation	false
pooled_resource_factors_display_name_negative_3k_main_pooled_factor_unity_from_assignments	Assignments	false
pooled_resource_factors_display_name_negative_3k_main_pooled_factor_population	Other	false
pooled_resource_factors_display_name_positive_3k_dlc04_pooled_factor_dynasty_influence_from_characters	Characters	false
pooled_resource_factors_display_name_positive_ep_pooled_factor_sima_wei_assignments	Assignments	false
pooled_resource_factors_display_name_positive_3k_dlc06_pooled_factor_mulu_pride_decay	Pride decay rate	false
pooled_resource_factors_display_name_negative_3k_main_pooled_factor_lineage	Lineage lost	false
pooled_resource_factors_display_name_positive_3k_dlc05_pooled_factor_momentum_decay	Momentum decay	false
pooled_resource_factors_display_name_positive_3k_dlc05_pooled_factor_shared_expertise_from_court_actions	Expertise gained from court actions	false
pooled_resource_factors_display_name_positive_3k_main_pooled_factor_supply_from_events	Events	false
pooled_resource_factors_display_name_positive_ep_pooled_factor_jurisdiction_people_in_power	People in power	false
pooled_resource_factors_display_name_negative_3k_dlc07_pooled_factor_lineage_tresspassing	Tresspassing	false
pooled_resource_factors_display_name_positive_3k_main_pooled_factor_annexation_currency_gain	HIDDEN	false
pooled_resource_factors_display_name_negative_3k_dlc04_pooled_factor_dynasty_influence_from_court_positions	Court positions	false
pooled_resource_factors_display_name_positive_ep_pooled_factor_subterfuge_buildings	Buildings	false
pooled_resource_factors_display_name_positive_ep_pooled_factor_demesne	Domain increased	false
pooled_resource_factors_display_name_positive_3k_main_pooled_factor_credibility_diplomacy	hidden	false
pooled_resource_factors_display_name_negative_ep_pooled_factor_demesne	Domain diminished	false
pooled_resource_factors_display_name_positive_3k_dlc04_pooled_factor_fervour_battles	Victories	false
pooled_resource_factors_display_name_negative_3k_dlc04_pooled_factor_political_influence_from_events	Events	false
pooled_resource_factors_display_name_negative_ep_pooled_factor_control_ministers	Ministers	false
pooled_resource_factors_display_name_negative_3k_dlc04_pooled_factor_bureaucrats_influence_from_court_positions	Court positions	false
pooled_resource_factors_display_name_positive_3k_main_pooled_factor_intimidation_decay	Gain rate	false
pooled_resource_factors_display_name_negative_3k_dlc07_pooled_factor_imperial_favour_governance	Governance	false
pooled_resource_factors_display_name_negative_ep_pooled_factor_jurisdiction	Jurisdiction lost	false
pooled_resource_factors_display_name_negative_3k_dlc04_pooled_factor_political_influence_from_warlords_power_level	Warlord empowerment	false
pooled_resource_factors_display_name_negative_ep_pooled_factor_control	Control lost	false
pooled_resource_factors_display_name_positive_3k_main_pooled_factor_supply	Supply	false
pooled_resource_factors_display_name_negative_3k_dlc04_pooled_factor_displaced_population	Displaced population decline	false
pooled_resource_factors_display_name_positive_3k_main_pooled_factor_population_from_food_reserves	Reserves	false
pooled_resource_factors_display_name_positive_3k_main_pooled_factor_lineage	Lineage gained	false
pooled_resource_factors_display_name_negative_3k_main_pooled_factor_population_distribution	Food distribution	false
pooled_resource_factors_display_name_negative_3k_dlc07_pooled_factor_lineage_prisoners_executed	Prisoners executed	false
pooled_resource_factors_display_name_positive_3k_dlc07_pooled_factor_lineage_settlement_captured	Settlements captured	false
pooled_resource_factors_display_name_positive_3k_dlc07_pooled_factor_lineage_captains_employed	Captains employed	false
pooled_resource_factors_display_name_negative_3k_dlc04_pooled_factor_fervour_regional_characters	Characters	false
pooled_resource_factors_display_name_negative_ep_pooled_factor_subterfuge_people_in_power	People in power	false
pooled_resource_factors_display_name_positive_3k_dlc06_pooled_factor_splendour_faction_leaders	Family-member Faction Leaders	false
pooled_resource_factors_display_name_positive_3k_dlc05_pooled_factor_food_from_banditry	Banditry	false
pooled_resource_factors_display_name_positive_3k_dlc04_pooled_factor_displaced_population_occupation_foreign	Foreign occupation	false
pooled_resource_factors_display_name_positive_3k_dlc04_pooled_factor_fortitude	Fortitude gained	false
pooled_resource_factors_display_name_positive_3k_dlc04_factor_domain_regions	Domain	false
pooled_resource_factors_display_name_negative_3k_dlc06_pooled_factor_mulu_pride_military_feats	Pride lost through military blunders	false
pooled_resource_factors_display_name_negative_3k_main_pooled_factor_supply_scheme	Schemes	false
pooled_resource_factors_display_name_positive_3k_dlc07_pooled_factor_imperial_favour_credibility	Credibility	false
pooled_resource_factors_display_name_positive_3k_dlc07_pooled_factor_lineage_sieges_defended	Sieges defended	false
pooled_resource_factors_display_name_negative_3k_dlc06_pooled_factor_mulu_rituals	Rituals Known	false
pooled_resource_factors_display_name_negative_3k_main_pooled_factor_population_events	Events	false
pooled_resource_factors_display_name_negative_ep_pooled_factor_control_faction_leader	Faction leader	false
pooled_resource_factors_display_name_positive_ep_pooled_factor_sima_wei	Fury	false
pooled_resource_factors_display_name_positive_3k_dlc04_pooled_factor_political_influence_from_events	Events	false
pooled_resource_factors_display_name_positive_3k_dlc05_pooled_factor_momentum_assignments	Assignments	false
pooled_resource_factors_display_name_positive_3k_main_pooled_factor_credibility_recovery	Recovery	false
pooled_resource_factors_display_name_positive_3k_main_pooled_factor_annexation_currency_expenditure	HIDDEN	false
pooled_resource_factors_display_name_negative_3k_dlc07_pooled_factor_lineage_settlement_captured	Settlements captured	false
pooled_resource_factors_display_name_negative_3k_main_pooled_factor_population_from_food_reserves	Reserves	false
pooled_resource_factors_display_name_negative_ep_pooled_factor_influence_faction_leader	Faction leader deployed in army	false
pooled_resource_factors_display_name_negative_3k_dlc05_pooled_factor_mercenary_activity	Fame & Fortune Decline	false
pooled_resource_factors_display_name_negative_3k_main_pooled_factor_heroism_decay	Heroism decay rate	false
pooled_resource_factors_display_name_positive_ep_pooled_factor_influence_battles	Victories	false
pooled_resource_factors_display_name_negative_3k_dlc04_pooled_factor_governance_vassals	Vassals	false
pooled_resource_factors_display_name_negative_3k_main_pooled_factor_annexation_currency_expenditure	HIDDEN	false
pooled_resource_factors_display_name_positive_3k_dlc07_pooled_factor_imperial_favour_legitimacy	Legitimacy	false
pooled_resource_factors_display_name_negative_3k_dlc07_pooled_factor_lineage_army_raised	Army raised	false
pooled_resource_factors_display_name_positive_3k_dlc04_pooled_factor_fervour_increase_from_economic_stength	Economy	false
pooled_resource_factors_display_name_negative_3k_dlc04_pooled_factor_fervour_increase_from_economic_stength	HIDDEN	false
pooled_resource_factors_display_name_negative_ep_pooled_factor_reformation_events	Events	false
pooled_resource_factors_display_name_positive_3k_main_pooled_factor_supply_post_siege	Sieges	false
pooled_resource_factors_display_name_positive_3k_dlc04_pooled_factor_political_influence_decrease_from_expenditure	HIDDEN	false
pooled_resource_factors_display_name_positive_3k_dlc04_pooled_factor_fervour_events	Events	false
pooled_resource_factors_display_name_negative_3k_main_pooled_factor_intimidation_executions	Executions	false
pooled_resource_factors_display_name_positive_ep_pooled_factor_fist_alignment	From events	false
pooled_resource_factors_display_name_negative_3k_main_pooled_factor_intimidation_from_battles	Defeats	false
pooled_resource_factors_display_name_negative_3k_main_pooled_factor_lineage_allies	Lineage from allies	false
pooled_resource_factors_display_name_negative_ep_pooled_factor_subterfuge_spies_1	Subterfuge	false
pooled_resource_factors_display_name_negative_3k_dlc04_pooled_factor_warlords_influence_from_characters	Characters	false
pooled_resource_factors_display_name_positive_3k_dlc04_pooled_factor_fervour_increase_from_faction_support	Faction support	false
pooled_resource_factors_display_name_positive_3k_main_pooled_factor_lineage_faction_leader	Faction leader deployed in army	false
pooled_resource_factors_display_name_positive_3k_dlc05_pooled_factor_mercenary_activity_settlement_occupations	Settlements Gifted	false
pooled_resource_factors_display_name_positive_3k_main_pooled_factor_population_characters	Characters	false
pooled_resource_factors_display_name_negative_3k_main_pooled_factor_supply_from_military_buildings	Military infrastructure	false
pooled_resource_factors_display_name_positive_3k_dlc06_pooled_factor_resource_goddess_of_fire_increase	Goddess of Fire gain rate	false
pooled_resource_factors_display_name_positive_ep_pooled_factor_subterfuge_spies_1	Innocuous spy activity	false
pooled_resource_factors_display_name_positive_3k_dlc04_pooled_factor_governance	Han influence	false
pooled_resource_factors_display_name_positive_3k_dlc07_pooled_factor_lineage_army_raised	Army raised	false
pooled_resource_factors_display_name_positive_3k_dlc05_pooled_factor_mercenary_activity_decay	HIDDEN	false
pooled_resource_factors_display_name_negative_3k_main_pooled_factor_credibility_recovery	Decay	false
pooled_resource_factors_display_name_negative_3k_dlc04_pooled_factor_fervour_increase_from_military_stength	HIDDEN	false
pooled_resource_factors_display_name_negative_3k_main_pooled_factor_population_faction	Faction	false
pooled_resource_factors_display_name_negative_ep_pooled_factor_reformation_buildings_negative	Conservative infrastructure	false
pooled_resource_factors_display_name_positive_3k_dlc07_pooled_factor_imperial_favour_food	Food Surplus	false
pooled_resource_factors_display_name_negative_3k_dlc07_pooled_factor_lineage_sieges_defended	Sieges defended	false
pooled_resource_factors_display_name_negative_3k_main_pooled_factor_legitimacy_recruitment	Recruitment	false
pooled_resource_factors_display_name_negative_3k_main_pooled_factor_credibility_diplomacy	Credibility expended in diplomacy	false
pooled_resource_factors_display_name_positive_3k_main_pooled_factor_unity_from_characters	Characters	false
pooled_resource_factors_display_name_positive_3k_main_pooled_factor_supply_scheme	Schemes	false
pooled_resource_factors_display_name_negative_3k_dlc06_pooled_factor_mulu_pride	Pride Lost	false
pooled_resource_factors_display_name_negative_3k_dlc04_pooled_factor_political_influence	Political influence decrease	false
pooled_resource_factors_display_name_positive_3k_dlc04_pooled_factor_fervour	Zeal increase	false
pooled_resource_factors_display_name_negative_3k_main_pooled_factor_supply_from_food	Food shortage	false
pooled_resource_factors_display_name_negative_ep_pooled_factor_reformation	Reformation	false
pooled_resource_factors_display_name_positive_3k_main_pooled_factor_population_technologies	Reforms	false
pooled_resource_factors_display_name_positive_ep_pooled_factor_jurisdiction_siege	Sieges	false
pooled_resource_factors_display_name_negative_ep_pooled_factor_demesne_regions	Overextended domain	false
pooled_resource_factors_display_name_positive_3k_dlc05_pooled_factor_momentum_battles_won	Battles won	false
pooled_resource_factors_display_name_positive_ep_pooled_factor_demesne_regions	Domain	false
pooled_resource_factors_display_name_negative_3k_dlc05_pooled_factor_momentum_settlements_razed	Settlements Razed	false
pooled_resource_factors_display_name_negative_ep_pooled_factor_sima_wei_battles	Defeats	false
pooled_resource_factors_display_name_positive_3k_dlc07_pooled_factor_ambition_spending	Aspiration spent	false
pooled_resource_factors_display_name_negative_3k_dlc04_factor_domain	Domain diminished	false
pooled_resource_factors_display_name_negative_3k_dlc05_pooled_factor_momentum_character_actions	Court Actions	false
pooled_resource_factors_display_name_negative_3k_dlc06_pooled_factor_mulu_pride_events	Events	false
pooled_resource_factors_display_name_positive_3k_dlc04_pooled_factor_fervour_regional_post_siege	Sieges	false
pooled_resource_factors_display_name_negative_ep_pooled_factor_control_assignment	Assignments	false
pooled_resource_factors_display_name_positive_ep_pooled_factor_reformation_administrators	{{tr:Governors}}	false
pooled_resource_factors_display_name_negative_3k_dlc05_pooled_factor_white_tiger_confederation	Confederation declines	false
pooled_resource_factors_display_name_positive_3k_main_pooled_factor_food_diplomacy	Diplomacy	false
pooled_resource_factors_display_name_negative_3k_main_pooled_factor_food_eunuchs	Eunuch policies	false
pooled_resource_factors_display_name_negative_3k_dlc04_pooled_factor_warlords_influence_from_court_positions	Court positions	false
pooled_resource_factors_display_name_negative_3k_dlc04_pooled_factor_displaced_population_decay	Ambient resettlement	false
pooled_resource_factors_display_name_positive_ep_pooled_factor_influence_faction_leader	Faction leader deployed in army	false
pooled_resource_factors_display_name_negative_ep_pooled_factor_jurisdiction_vassals	Vassals	false
pooled_resource_factors_display_name_positive_3k_main_pooled_factor_food_from_foraging	Foraging	false
pooled_resource_factors_display_name_positive_3k_dlc05_pooled_factor_reckless_luck_decay	Reckless luck decay rate	false
pooled_resource_factors_display_name_negative_3k_dlc07_pooled_factor_ambition_tradeoffs	Aspiration from trade-offs	false
pooled_resource_factors_display_name_negative_3k_dlc04_pooled_factor_fervour_regional	{{tr:dlc04_term_regional_fervour}}	false
pooled_resource_factors_display_name_positive_3k_dlc04_pooled_factor_political_influence_from_assignments	Assignments	false
pooled_resource_factors_display_name_positive_3k_main_pooled_factor_food_assignments	Assignments	false
pooled_resource_factors_display_name_negative_ep_pooled_factor_brain_alignment	From events	false
pooled_resource_factors_display_name_negative_3k_dlc05_pooled_factor_supply_from_consumption	Consumption	false
pooled_resource_factors_display_name_negative_ep_pooled_factor_influence	Influence	false
pooled_resource_factors_display_name_negative_3k_dlc04_pooled_factor_fortitude_events	Events	false
pooled_resource_factors_display_name_negative_3k_main_pooled_factor_supply_sabotage	Sabotage	false
pooled_resource_factors_display_name_positive_3k_main_pooled_factor_intimidation_faction_leader_death	Succession	false
pooled_resource_factors_display_name_positive_3k_dlc04_pooled_factor_dynasty_influence	Imperial dynasty influence increase	false
pooled_resource_factors_display_name_positive_3k_main_pooled_factor_intimidation_assignments	Assignments	false
pooled_resource_factors_display_name_positive_3k_dlc06_pooled_factor_mulu_rituals	Rituals Known	false
pooled_resource_factors_display_name_positive_ep_pooled_factor_reformation_assignments	Assignments	false
pooled_resource_factors_display_name_positive_ep_pooled_factor_sima_wei_post_siege	Sieges	false
pooled_resource_factors_display_name_negative_3k_main_pooled_factor_lineage_siege_options	Occupation options	false
pooled_resource_factors_display_name_positive_ep_pooled_factor_influence_buildings	Infrastructure	false
pooled_resource_factors_display_name_negative_3k_main_pooled_factor_population_characters	Characters	false
pooled_resource_factors_display_name_positive_3k_main_pooled_factor_intimidation_executions	Executions	false
pooled_resource_factors_display_name_positive_3k_dlc06_pooled_factor_mulu_pride_events	Events	false
pooled_resource_factors_display_name_negative_3k_dlc06_pooled_factor_mulu_pride_from_rituals	Pride from known rituals	false
pooled_resource_factors_display_name_positive_3k_main_pooled_factor_infamy_from_conquest	Conquest	false
pooled_resource_factors_display_name_negative_3k_dlc04_pooled_factor_displaced_population_occupation_foreign	Foreign occupation	false
pooled_resource_factors_display_name_positive_3k_dlc06_pooled_factor_shamoke_vassalise	CO-OPERATION	false
pooled_resource_factors_display_name_negative_3k_main_pooled_factor_population_post_siege	Sieges	false
pooled_resource_factors_display_name_positive_3k_main_pooled_factor_intimidation_events	Events	false
pooled_resource_factors_display_name_positive_3k_main_pooled_factor_population	Other	false
pooled_resource_factors_display_name_positive_ep_pooled_factor_subterfuge_diplomacy	Subterfuge	false
pooled_resource_factors_display_name_negative_3k_main_pooled_factor_lineage_recruitment	Recruitment	false
pooled_resource_factors_display_name_negative_3k_main_pooled_factor_infamy_from_tribute	Tribute earned	false
pooled_resource_factors_display_name_negative_ep_pooled_factor_reformation_buildings_positive	Conservative infrastructure	false
pooled_resource_factors_display_name_negative_3k_dlc06_pooled_factor_shamoke_vassalise	CO-OPERATION	false
pooled_resource_factors_display_name_negative_3k_dlc04_pooled_factor_fervour_regional_forces	Forces	false
pooled_resource_factors_display_name_negative_3k_main_pooled_factor_supply_from_buildings	Infrastructure	false
pooled_resource_factors_display_name_positive_3k_main_pooled_factor_infamy	Infamy gained	false
pooled_resource_factors_display_name_negative_3k_main_pooled_factor_lineage_faction_leader	Faction leader deployed in army	false
pooled_resource_factors_display_name_negative_3k_main_pooled_factor_heroism	Heroism lost	false
pooled_resource_factors_display_name_negative_3k_dlc04_pooled_factor_fervour_post_siege	Sieges	false
pooled_resource_factors_display_name_negative_ep_pooled_factor_sima_wei_post_siege	Sieges	false
pooled_resource_factors_display_name_negative_3k_dlc04_pooled_factor_fervour_regional_fervour	{{tr:dlc04_term_fervour}}	false
pooled_resource_factors_display_name_positive_ep_pooled_factor_influence	Influence	false
pooled_resource_factors_display_name_positive_ep_pooled_factor_influence_assignments	Assignments	false
pooled_resource_factors_display_name_positive_3k_dlc04_pooled_factor_dynasty_influence_from_court_positions	Court positions	false
pooled_resource_factors_display_name_negative_3k_dlc04_pooled_factor_dynasty_influence_from_characters	Characters	false
pooled_resource_factors_display_name_negative_3k_main_pooled_factor_supply_from_assignments	Assignments	false
pooled_resource_factors_display_name_positive_3k_dlc06_pooled_factor_family_member_faction_leaders	Family-member Faction Leaders	false
pooled_resource_factors_display_name_positive_3k_dlc04_pooled_factor_fortitude_decay	Fortitude decay rate	false
pooled_resource_factors_display_name_positive_3k_dlc06_pooled_factor_splendour_tribute_chests	Tribute Chests created	false
pooled_resource_factors_display_name_positive_3k_dlc05_pooled_factor_supply_from_consumption	Foraging	false
pooled_resource_factors_display_name_negative_3k_dlc07_pooled_factor_ambition_buildings	Aspiration from buildings	false
pooled_resource_factors_display_name_negative_ep_pooled_factor_influence_buildings	Infrastructure	false
pooled_resource_factors_display_name_positive_3k_main_pooled_factor_population_hostile_forces	Hostile forces	false
pooled_resource_factors_display_name_negative_3k_main_pooled_factor_unity_from_events	Events & missions	false
pooled_resource_factors_display_name_positive_ep_pooled_factor_reformation_buildings_negative	Reformed infrastructure	false
pooled_resource_factors_display_name_positive_3k_dlc04_pooled_factor_political_influence	Political influence increase	false
pooled_resource_factors_display_name_positive_3k_main_pooled_factor_trade_monopoly_decay	Market forces	false
pooled_resource_factors_display_name_positive_3k_main_pooled_factor_population_distribution	Food distribution	false
pooled_resource_factors_display_name_negative_ep_pooled_factor_subterfuge_spies_3	Subterfuge	false
pooled_resource_factors_display_name_positive_3k_dlc04_pooled_factor_displaced_population_occupation_domestic	Domestic occupation	false
pooled_resource_factors_display_name_negative_3k_main_pooled_factor_intimidation_annexation	Integrated Han Empire	false
pooled_resource_factors_display_name_positive_3k_dlc07_pooled_factor_imperial_favour_public_order	Public Order	false
pooled_resource_factors_display_name_negative_3k_main_pooled_factor_population_technologies	Reforms	false
pooled_resource_factors_display_name_negative_3k_dlc06_pooled_factor_mulu_pride_decay	Pride decay rate	false
pooled_resource_factors_display_name_positive_ep_pooled_factor_brain_alignment	From events	false
pooled_resource_factors_display_name_negative_3k_dlc07_pooled_factor_imperial_favour_post_siege	Occupation Atrocities	false
pooled_resource_factors_display_name_positive_3k_dlc07_pooled_factor_imperial_favour_events	Events	false
pooled_resource_factors_display_name_negative_3k_main_pooled_factor_food_sold	Food markets	false
pooled_resource_factors_display_name_positive_3k_dlc04_pooled_factor_fervour_post_siege	Sieges	false
pooled_resource_factors_display_name_positive_3k_dlc07_pooled_factor_lineage_prisoners_executed	Prisoners executed	false
pooled_resource_factors_display_name_negative_3k_dlc04_pooled_factor_political_influence_from_bureaucracy_power_level	Bureaucrat empowerment	false
pooled_resource_factors_display_name_negative_3k_dlc07_pooled_factor_imperial_favour_characters_people_in_power	Faction Leader Rank	false
pooled_resource_factors_display_name_positive_ep_pooled_factor_control_remove	Removed opposition	false
pooled_resource_factors_display_name_positive_3k_main_pooled_factor_legitimacy_recruitment	Recruitment	false
pooled_resource_factors_display_name_negative_3k_main_pooled_factor_unity_from_characters	Characters	false
pooled_resource_factors_display_name_positive_3k_main_pooled_factor_population_events	Events	false
pooled_resource_factors_display_name_negative_3k_dlc04_pooled_factor_fervour_decrease_from_decay	Zeal decay rate	false
pooled_resource_factors_display_name_positive_3k_main_pooled_factor_supply_sabotage	Sabotage	false
pooled_resource_factors_display_name_positive_3k_dlc07_pooled_factor_ambition_tradeoffs	Aspiration from trade-offs	false
pooled_resource_factors_display_name_positive_3k_dlc07_pooled_factor_ambition_tradeoffs_tracker	HIDDEN	false
pooled_resource_factors_display_name_positive_ep_pooled_factor_sima_wei_battles	Victories	false
pooled_resource_factors_display_name_positive_3k_main_pooled_factor_legitimacy_assignments	Assignments	false
pooled_resource_factors_display_name_positive_3k_dlc04_pooled_factor_displaced_population_resettlement	Resettlement efforts	false
pooled_resource_factors_display_name_positive_3k_dlc06_pooled_factor_mulu_pride_military_feats	Pride earned through military feats	false
pooled_resource_factors_display_name_positive_3k_main_pooled_factor_lineage_decay	Lineage fading	false
pooled_resource_factors_display_name_negative_3k_dlc06_pooled_factor_family_member_faction_leaders	Family Member Faction Leaders	false
pooled_resource_factors_display_name_negative_3k_dlc05_pooled_factor_momentum_battles_won	Battles Won	false
pooled_resource_factors_display_name_positive_ep_pooled_factor_reformation_events	Events	false
pooled_resource_factors_display_name_negative_3k_dlc04_pooled_factor_fervour_events	Events	false
pooled_resource_factors_display_name_positive_ep_pooled_factor_subterfuge_people_in_power	People in power	false
pooled_resource_factors_display_name_negative_3k_main_pooled_factor_supply_from_events	Events	false
pooled_resource_factors_display_name_positive_3k_main_pooled_factor_intimidation_razed_settlements	Razing & sacking	false
pooled_resource_factors_display_name_negative_ep_pooled_factor_sima_wei_gifts	Gifts	false
pooled_resource_factors_display_name_positive_3k_main_pooled_factor_supply_from_buildings	Infrastructure	false
pooled_resource_factors_display_name_positive_3k_dlc04_pooled_factor_displaced_population_decay	Ambient resettlement	false
pooled_resource_factors_display_name_negative_3k_main_pooled_factor_credibility_events	Events	false
pooled_resource_factors_display_name_positive_ep_pooled_factor_reformation	Reformation	false
pooled_resource_factors_display_name_positive_ep_pooled_factor_control_ministers	Ministers	false
pooled_resource_factors_display_name_positive_3k_dlc07_pooled_factor_imperial_favour_enemy_of_the_han	Interactions with an Enemy of the Han	false
pooled_resource_factors_display_name_negative_3k_dlc05_pooled_factor_momentum_decay	Momentum Decay	false
pooled_resource_factors_display_name_negative_3k_dlc07_pooled_factor_imperial_favour	Imperial Favour	false
pooled_resource_factors_display_name_negative_ep_pooled_factor_subterfuge_diplomacy	Subterfuge expended in diplomacy	false
pooled_resource_factors_display_name_negative_3k_dlc05_pooled_factor_personal_victories_characters_defeated	New Faction Leader	false
pooled_resource_factors_display_name_positive_3k_dlc04_pooled_factor_displaced_population	Displaced population growth	false
pooled_resource_factors_display_name_positive_3k_main_pooled_factor_heroism_from_military_feats	Heroism earned through military feats	false
pooled_resource_factors_display_name_negative_3k_main_pooled_factor_infamy_from_conquest	Conquest	false
pooled_resource_factors_display_name_positive_ep_pooled_factor_jurisdiction	Jurisdiction gained	false
pooled_resource_factors_display_name_negative_3k_main_pooled_factor_legitimacy_buildings	Buildings	false
pooled_resource_factors_display_name_positive_3k_dlc07_pooled_factor_imperial_favour_intimidation	Intimidation	false
pooled_resource_factors_display_name_negative_3k_dlc04_pooled_factor_fervour_regional_events	Events	false
pooled_resource_factors_display_name_negative_3k_dlc04_pooled_factor_fervour_regional_post_siege	Sieges	false
pooled_resource_factors_display_name_negative_3k_dlc05_pooled_factor_mercenary_activity_events	Events	false
pooled_resource_factors_display_name_positive_3k_main_pooled_factor_credibility	Credibility gained	false
pooled_resource_factors_display_name_positive_3k_main_pooled_factor_annexation_currency	HIDDEN	false
pooled_resource_factors_display_name_positive_3k_dlc06_pooled_factor_resource_flaming_confinement_increase	Flaming Confinement gain rate	false
pooled_resource_factors_display_name_positive_3k_main_pooled_factor_population_faction	Faction	false
pooled_resource_factors_display_name_positive_ep_pooled_factor_money_alignment	From events	false
pooled_resource_factors_display_name_negative_3k_main_pooled_factor_infamy_decay	Infamy decay	false
pooled_resource_factors_display_name_positive_3k_dlc04_pooled_factor_fervour_regional_forces	Forces	false
pooled_resource_factors_display_name_negative_3k_main_pooled_factor_population_public_order	{{tr:Public_order}}	false
pooled_resource_factors_display_name_negative_3k_main_pooled_factor_population_conscription	Conscription	false
pooled_resource_factors_display_name_positive_3k_main_pooled_factor_satisfaction	High satisfaction	false
