key	text	tooltip
#Loc;1;text/mtu_text/[01]__MTU_generals__Water_strategist.loc		
land_units_onscreen_name_3k_mtu_hero_water_lady_lu_zheng	Lu Zheng	false
land_units_onscreen_name_3k_mtu_general_water_lady_lu_zheng	Lu Zheng	false
ceo_nodes_title_3k_mtu_ceo_node_career_historical_lady_lu_zheng_01	Scout of Taiyuan	true
ceo_nodes_description_3k_mtu_ceo_node_career_historical_lady_lu_zheng_01	She transforms the sound of her bow and movement of her troops into a violent and beautiful song and dance.	true
custom_battle_loadouts_name_3k_mtu_custom_battle_loadout_lady_lu_zheng_01	Bandit	true
custom_battle_loadouts_name_3k_mtu_custom_battle_loadout_lady_lu_zheng_02	Warlord	true
custom_battle_loadouts_name_3k_mtu_custom_battle_loadout_lady_lu_zheng_03	Scout of Taiyuan	true
land_units_onscreen_name_3k_mtu_hero_water_hua_xin	Hua Xin	false
land_units_onscreen_name_3k_mtu_general_water_hua_xin	Hua Xin	false
ceo_nodes_title_3k_mtu_ceo_node_career_historical_hua_xin_01	Ignoble Opportunist	true
ceo_nodes_description_3k_mtu_ceo_node_career_historical_hua_xin_01	A man of measured approach, but also a keen opportunist that does not let go by a chance to climb higher.	true
custom_battle_loadouts_name_3k_mtu_custom_battle_loadout_hua_xin_01	Secretary	true
custom_battle_loadouts_name_3k_mtu_custom_battle_loadout_hua_xin_02	Chancellor	true
custom_battle_loadouts_name_3k_mtu_custom_battle_loadout_hua_xin_03	Ignoble Opportunist	true
land_units_onscreen_name_3k_mtu_hero_water_cai_yan	Cai Yan	false
land_units_onscreen_name_3k_mtu_general_water_cai_yan	Cai Yan	false
ceo_nodes_title_3k_dlc04_ceo_node_career_historical_lady_cai_yan_wenji_01	Tragic Writer	false
ceo_nodes_title_3k_mtu_ceo_node_career_historical_lady_cai_yan_01	Tragic Writer	true
ceo_nodes_description_3k_dlc04_ceo_node_career_historical_lady_cai_yan_wenji_01	She never gave up in life - her art and her will were passed on from generation to generation.	false
ceo_nodes_description_3k_mtu_ceo_node_career_historical_lady_cai_yan_01	She never gave up in life - her art and her will were passed on from generation to generation.	true
custom_battle_loadouts_name_3k_mtu_custom_battle_loadout_lady_cai_yan_01	Kidnapped Girl	true
custom_battle_loadouts_name_3k_mtu_custom_battle_loadout_lady_cai_yan_02	Suffered Woman	true
custom_battle_loadouts_name_3k_mtu_custom_battle_loadout_lady_cai_yan_03	Spiritualized Rage	true
land_units_onscreen_name_3k_mtu_hero_metal_lady_xiao_qiao	Yuan Anyang	false
land_units_onscreen_name_3k_mtu_general_metal_lady_xiao_qiao	Yuan Anyang	false
ceo_nodes_title_3k_mtu_ceo_node_career_historical_lady_xiao_qiao_01	Princess Zhong	true
ceo_nodes_description_3k_mtu_ceo_node_career_historical_lady_xiao_qiao_01	The beauty and qualities of Yuan Anyang, a princess of the Kingdom of Zhong, are known throughout the land.	true
custom_battle_loadouts_name_3k_mtu_custom_battle_loadout_lady_xiao_qiao_01	Lady	true
custom_battle_loadouts_name_3k_mtu_custom_battle_loadout_lady_xiao_qiao_02	Queen	true
custom_battle_loadouts_name_3k_mtu_custom_battle_loadout_lady_xiao_qiao_03	Princess Zhong	true
land_units_onscreen_name_3k_mtu_hero_water_lady_gongsun_jinting	Hou Jinting	false
land_units_onscreen_name_3k_mtu_general_water_lady_gongsun_jinting	Hou Jinting	false
ceo_nodes_title_3k_mtu_ceo_node_career_historical_lady_gongsun_jinting_01	Sacrificial Matriarch	true
ceo_nodes_description_3k_mtu_ceo_node_career_historical_lady_gongsun_jinting_01	The stakes are raised on the fringes of the empire; Hou Jintingâ€™s keen senses and vigilance safeguard the future of her family.	true
custom_battle_loadouts_name_3k_mtu_custom_battle_loadout_gongsun_jinting_01	Strategist	true
custom_battle_loadouts_name_3k_mtu_custom_battle_loadout_gongsun_jinting_02	Advisor	true
custom_battle_loadouts_name_3k_mtu_custom_battle_loadout_gongsun_jinting_03	Sacrificial Matriarch	true
land_units_onscreen_name_3k_mtu_hero_water_yan_xiang	Yan Xiang	false
land_units_onscreen_name_3k_mtu_general_water_yan_xiang	Yan Xiang	false
ceo_nodes_title_3k_mtu_ceo_node_career_historical_yan_xiang_01	Sagacious Seer	true
ceo_nodes_description_3k_mtu_ceo_node_career_historical_yan_xiang_01	Blessed with prodigious foresight, Yan Xiang forsees perils and pitfalls long before they arise.	true
custom_battle_loadouts_name_3k_mtu_custom_battle_loadout_yan_xiang_01	Registrar	true
custom_battle_loadouts_name_3k_mtu_custom_battle_loadout_yan_xiang_02	Calculated Advisor	true
custom_battle_loadouts_name_3k_mtu_custom_battle_loadout_yan_xiang_03	Sagacious Seer	true
land_units_onscreen_name_3k_mtu_hero_water_lady_dong_bai	Dong Bai	false
land_units_onscreen_name_3k_mtu_general_water_lady_dong_bai	Dong Bai	false
ceo_nodes_title_3k_mtu_ceo_node_career_historical_lady_dong_bai_01	Successful Girl	true
ceo_nodes_description_3k_mtu_ceo_node_career_historical_lady_dong_bai_01	At an early age, Dong Zhuo gave Dong Bai his land to her. For some reason, her personality and reputation are not very good, but no one has been treated recklessly because of Dong Zhuo who takes care of her.	true
custom_battle_loadouts_name_3k_mtu_custom_battle_loadout_lady_dong_bai_01	Successful Girl	false
custom_battle_loadouts_name_3k_mtu_custom_battle_loadout_lady_dong_bai_02	Successful Girl	false
custom_battle_loadouts_name_3k_mtu_custom_battle_loadout_lady_dong_bai_03	Successful Girl	false
land_units_onscreen_name_3k_mtu_hero_water_lady_zou_yuan	Zou Yuan	false
land_units_onscreen_name_3k_mtu_general_water_lady_zou_yuan	Zou Yuan	false
ceo_nodes_title_3k_mtu_ceo_node_career_historical_lady_zou_yuan_01	Eternal Beauty	false
ceo_nodes_description_3k_mtu_ceo_node_career_historical_lady_zou_yuan_01	Zou Yuan, the beauty everyone coveted, was widely known for her beauty. So many heroes wanted to keep her next to them at all costs. To the extent that Cao Cao lost his son and his general during the secret meeting with her at night.	false
custom_battle_loadouts_name_3k_mtu_custom_battle_loadout_lady_zou_yuan_01	Eternal Beauty	false
custom_battle_loadouts_name_3k_mtu_custom_battle_loadout_lady_zou_yuan_02	Eternal Beauty	false
custom_battle_loadouts_name_3k_mtu_custom_battle_loadout_lady_zou_yuan_03	Eternal Beauty	false
