key	text	tooltip
#Loc;1;text/[04]__MTU_events__Common.loc		
incidents_localised_title_mtu_zhou_yu_spawns_incident	英杰周瑜	true
incidents_localised_description_mtu_zhou_yu_spawns_incident	才智过人，忠诚有加而又仪表堂堂的咒语，从少年时期就是孙策的密友了。两人自幼形影不离，而且对互相的家族也十分敬重。周瑜的音乐才华无人能比，说明他既才华横溢，又有礼有节。	true
incidents_localised_title_mtu_two_qiao_marry_incident_pc	二乔	true
incidents_localised_description_mtu_two_qiao_marry_incident_pc	皖城乔公有两个女儿，皆国色也。乔公闻孙策与周瑜的大名，特来将两位女儿许配给两位将军。	true
incidents_localised_title_mtu_two_qiao_marry_incident_npc	江东二乔	true
incidents_localised_description_mtu_two_qiao_marry_incident_npc	随着乔公将两位女儿许给了孙策与周瑜，二乔的美貌与风雅名扬江东。	true
dilemmas_localised_title_mtu_dilemma_suggestion_of_rebel_sisters	不臣之心	true
dilemmas_localised_description_mtu_dilemma_suggestion_of_rebel_sisters	随着匪帮的扩张，众将中难免会有人持不臣之心。其中朱土，朱崩二人野心勃勃，势力日益壮大，准备推翻你。 \\n\\n 想要收复她们的忠诚，恐怕得花费不少金银俸禄。	true
cdir_events_dilemma_choice_details_localised_choice_label_mtu_dilemma_suggestion_of_rebel_sistersFIRST	妥协	true
cdir_events_dilemma_choice_details_localised_choice_label_mtu_dilemma_suggestion_of_rebel_sistersSECOND	拒绝和解	true
cdir_events_dilemma_choice_details_localised_choice_title_mtu_dilemma_suggestion_of_rebel_sistersFIRST	得人钱财，与人消灾，有钱能使鬼都推磨！	true
cdir_events_dilemma_choice_details_localised_choice_title_mtu_dilemma_suggestion_of_rebel_sistersSECOND	你坚定的拒绝了与她们妥协。	true
incidents_localised_title_mtu_zhu_sisters_robbery_incident	乱臣贼子	true
incidents_localised_description_mtu_zhu_sisters_robbery_incident	野心勃勃的土，崩二人开始了对你的反叛，她们想夺取王位，取你首级！	true
incidents_localised_title_3k_mtu_global_event_zhao_yun_becomes_zhenjun_general	虎威将军	true
incidents_localised_description_3k_mtu_global_event_zhao_yun_becomes_zhenjun_general	你听军士讲述常山赵子龙救黄忠、拒汉水之事，你称子龙“一身是胆”，并号其为虎威将军，大劳将士，欢宴至晚。	true
campaign_payload_ui_details_description_mtu_zhao_yun_get_new_armour	解锁虎威将军的护甲	true
campaign_payload_ui_details_description_mtu_zhao_yun_appointed_zhenjunjiangjun	加封赵云为虎威将军	true
campaign_payload_ui_details_description_mtu_zhao_yun_get_blue_blade	赵云在战场上夺得了一把泛着青光的短剑，看靶上有金嵌「青釭」二字，方知是宝剑也	true
effect_bundles_localised_title_3k_mtu_effect_bundle_dec_public_order_5_for_cai	昏君	true
effect_bundles_localised_description_3k_mtu_effect_bundle_dec_public_order_5_for_cai	钱财不拿来造福人民，却用于赎买美色。此举会使百姓不满。	true
effect_bundles_localised_title_3k_mtu_effect_bundle_dec_public_order_5	残忍	true
effect_bundles_localised_description_3k_mtu_effect_bundle_dec_public_order_5	恶有恶报。种其因者,须食其果。	true
effect_bundles_localised_title_3k_mtu_effect_bundle_inc_public_order_5	仁德	true
effect_bundles_localised_description_3k_mtu_effect_bundle_inc_public_order_5	有仁有德之君必得人心。	true
effect_bundles_localised_title_3k_mtu_effect_bundle_inc_public_order_6	稳重	true
effect_bundles_localised_description_3k_mtu_effect_bundle_inc_public_order_6	做事应该顾全大局，而不是唯利是图。	true
LU BU EVENT------------------------------------------------------------------------------------------		true
campaign_payload_ui_details_description_dummy_mtu_lu_bu_interpose	吕布介入了袁术与刘备的争斗之中，并尝试促使双方讲和。	true
incidents_localised_title_3k_mtu_global_event_lu_bu_interposes_yuan_and_liu_incident	辕门射戟	true
incidents_localised_description_3k_mtu_global_event_lu_bu_interposes_yuan_and_liu_incident	袁刘两家开战，吕布为了自己的利益决定尝试促使双方讲和。于是吕布设下酒席并邀请双方赴宴。吕布告诉双方的将领他厌恶争斗。交战的双方一方是他的亲家，一方他的贤弟，如果双方要争斗那不如依照天意，如果他能射中营中一百五十步外戟上的小支，那双方就立马停战。袁刘双方出于对吕布的尊重接受了提议，并在惊叹中目睹了箭矢穿过了一百五十步外戟上的小支。	true
dilemmas_localised_title_3k_mtu_global_event_lu_bu_interposes_yuan_and_liu_dilemma_lb	辕门射戟	true
dilemmas_localised_description_3k_mtu_global_event_lu_bu_interposes_yuan_and_liu_dilemma_lb	不出所料，袁刘两家果然开战了。出于本方的利益，你与你的谋士参议，决定邀请两家来到营中，并尝试讲和。 	true
cdir_events_dilemma_choice_details_localised_choice_label_3k_mtu_global_event_lu_bu_interposes_yuan_and_liu_dilemma_lbFIRST	设下宴席	true
cdir_events_dilemma_choice_details_localised_choice_label_3k_mtu_global_event_lu_bu_interposes_yuan_and_liu_dilemma_lbSECOND	随他们去吧	true
cdir_events_dilemma_choice_details_localised_choice_title_3k_mtu_global_event_lu_bu_interposes_yuan_and_liu_dilemma_lbFIRST	交战双方双双接受邀请前来赴宴，你向他们解释了邀请双方的原因以及依从天意的提议。袁刘两家都接受了你的提议，并在惊叹中目睹了箭矢穿过了一百五十步外戟上的小支。	true
cdir_events_dilemma_choice_details_localised_choice_title_3k_mtu_global_event_lu_bu_interposes_yuan_and_liu_dilemma_lbSECOND	袁刘两家相争，与你毫无相干。你深知与其插手其中，不如令鹤蚌相争，最后还可以方渔翁得利。	true
dilemmas_localised_title_3k_mtu_global_event_lu_bu_interposes_yuan_and_liu_dilemma_yl	辕门射戟	true
dilemmas_localised_description_3k_mtu_global_event_lu_bu_interposes_yuan_and_liu_dilemma_yl	大战将至，吕布派来的使节却突然来访，邀请你去参加他设下的宴席。虽然可疑，但你相信你们昔日的旧情于是前往赴宴。你在到达后却发现敌军大将纪灵也在席上，吕布解释道他平生痛恨争斗，希望此次争斗能依天意而行。他提议如果他能射中营中一百五十步外戟上的小支，双方就必须停战。	true
cdir_events_dilemma_choice_details_localised_choice_label_3k_mtu_global_event_lu_bu_interposes_yuan_and_liu_dilemma_ylFIRST	遵从天意	true
cdir_events_dilemma_choice_details_localised_choice_label_3k_mtu_global_event_lu_bu_interposes_yuan_and_liu_dilemma_ylSECOND	拒绝吕布的提议	true
cdir_events_dilemma_choice_details_localised_choice_title_3k_mtu_global_event_lu_bu_interposes_yuan_and_liu_dilemma_ylFIRST	双方都接受了吕布的提议，并在惊叹中目睹了吕布在一百五十步外射中了戟上的小支。	true
cdir_events_dilemma_choice_details_localised_choice_title_3k_mtu_global_event_lu_bu_interposes_yuan_and_liu_dilemma_ylSECOND	 吕布生性狡猾，此举必然有诈。你谢过了吕布的宴席，回营深思退敌之计。	true
LADY TRIEU EVENT------------------------------------------------------------------------------------------		true
dilemmas_localised_title_3k_mtu_global_event_lady_trieu_rumor_dilemma	天上明星	true
dilemmas_localised_description_3k_mtu_global_event_lady_trieu_rumor_dilemma	月明星稀，你在漫步于后院苦思于谋策之时发现了夜空中闪耀着一颗明亮的金星。当晚就寝时，一位先知现于梦中，说如若举行祭天大典你便可改变历史。次日，这想法充斥着你的脑海。虽是场梦，但却如此生动，常现在脑海中挥之不去。	true
campaign_payload_ui_details_description_dummy_mtu_lady_trieu_rumor	赵妪将现身于一个南方国度	true
campaign_payload_ui_details_description_dummy_mtu_lady_trieu_historic	赵妪将遵循历史自成一派	true
cdir_events_dilemma_choice_details_localised_choice_label_3k_mtu_global_event_lady_trieu_rumor_dilemmaFIRST	举办祭天大典	true
cdir_events_dilemma_choice_details_localised_choice_label_3k_mtu_global_event_lady_trieu_rumor_dilemmaSECOND	不过是个梦罢了	true
cdir_events_dilemma_choice_details_localised_choice_title_3k_mtu_global_event_lady_trieu_rumor_dilemmaFIRST	你带著随从，攀上高山举办祭典。夜晚来临，你发现金星比之前见到时更加明亮了。次日，你从细作口中得知，一位名叫赵妪的女中豪杰加入了某个派系，活跃于南方。	true
cdir_events_dilemma_choice_details_localised_choice_title_3k_mtu_global_event_lady_trieu_rumor_dilemmaSECOND	你渐渐的忘记了此事，岂能让一个梦耽误了你的霸业？	true
incidents_localised_title_3k_mtu_global_event_lady_trieu_rise_incident	交部骚动	true
incidents_localised_description_3k_mtu_global_event_lady_trieu_rise_incident	我方活跃于交州的细作禀报最近一位赵姓妇人以人民的名义率兵起义对抗交州军队，并将其击败。据说此人夺取了城池并自成一派。时间会告诉你是否得到一个盟友，还是一个敌人。	true
		true
incidents_localised_title_hv_incident_chunyu_qiong	临崖勒马	true
incidents_localised_description_hv_incident_chunyu_qiong	曾比肩袁曹，现却成日饮酒作乐，荒废才能。不料淳于琼在危难之际却悬崖勒马，重振其西园校尉之威。	true
dilemmas_localised_title_hv_dilemma_guan_ping	关圣太子	true
dilemmas_localised_description_hv_dilemma_guan_ping	刘备一行人途经冀州关家庄，庄主关定见刘关张英雄盖世而关羽又为其同宗兄弟，欲使其次子关平与三人一同匡扶汉室，于是刘备主张关羽与关平为义父子。	true
cdir_events_dilemma_choice_details_localised_choice_label_hv_dilemma_guan_pingFIRST	此事甚好	true
cdir_events_dilemma_choice_details_localised_choice_label_hv_dilemma_guan_pingSECOND	此事不妥	true
cdir_events_dilemma_choice_details_localised_choice_title_mtu_dilemma_suggestion_of_rebel_sistersFIRST		false
cdir_events_dilemma_choice_details_localised_choice_title_mtu_dilemma_suggestion_of_rebel_sistersSECOND		false
