key	text	tooltip
#Loc;1;text/!@hv_TEXT_CEO_UNIT_UNLOCKS.loc		
campaign_effect_scopes_localised_text_hv_scope_character_unlock_units_t1	[[col:scope_description]]（仅当该人物是丞相、储君或派系领袖时生效）[[/col]]	true
campaign_effect_scopes_localised_text_hv_scope_character_unlock_units_t2	[[col:scope_description]]( 要求派系等级 2 或更高 )\\n（（仅当该人物是丞相、储君或派系领袖时生效）[[/col]]	true
campaign_effect_scopes_localised_text_hv_scope_character_unlock_units_t3	[[col:scope_description]]( 要求派系等级 3 或更高 )\\n（（仅当该人物是丞相、储君或派系领袖时生效）[[/col]]	true
campaign_effect_scopes_localised_text_hv_scope_character_unlock_units_t4	[[col:scope_description]]( 要求派系等级 4 或更高 )\\n（（仅当该人物是丞相、储君或派系领袖时生效）[[/col]]	true
campaign_effect_scopes_localised_text_hv_scope_character_unlock_units_t5	[[col:scope_description]]( 要求派系等级 5 或更高 )\\n（（仅当该人物是丞相、储君或派系领袖时生效）[[/col]]	true
effects_description_hv_effect_dummy_unlock_guo_jia_1	解锁部队：投火弩兵	true
effects_description_hv_effect_dummy_unlock_huang_gai_1	解锁部队：斧兵团	true
effects_description_hv_effect_dummy_unlock_huangfu_song_1	解锁部队：护土枪兵、护土弓兵	true
effects_description_hv_effect_dummy_unlock_jia_xu_1	解锁部队：敛锷军	true
effects_description_hv_effect_dummy_unlock_lu_zhi_1	解锁部队：浪世匠人、护土枪兵、护土弓兵	true
effects_description_hv_effect_dummy_unlock_prince_liu_chong_1	解锁部队：陈郡泰平卫士	true
effects_description_hv_effect_dummy_unlock_chen_gong_1	解锁部队：鸱鸮射手	true
effects_description_hv_effect_dummy_unlock_cheng_pu_1	解锁部队：斧兵团	true
effects_description_hv_effect_dummy_unlock_gao_shun_1	解锁部队：陷阵营	true
effects_description_hv_effect_dummy_unlock_yan_baihu_1	解锁部队：白虎枪兵	true
effects_description_hv_effect_dummy_unlock_zhou_tai_1	解锁部队：敛锷军	true
effects_description_hv_effect_dummy_unlock_cao_cao_1	解锁部队：青州手戟步兵、青州长斧兵	true
effects_description_hv_effect_dummy_unlock_cao_ren_1	解锁部队：鸱鸮射手	true
effects_description_hv_effect_dummy_unlock_dong_min_1	解锁部队：飞熊军	true
effects_description_hv_effect_dummy_unlock_dong_zhuo_1	解锁部队：飞熊军	true
effects_description_hv_effect_dummy_unlock_gan_ning_1	解锁部队：浪世匠人	true
effects_description_hv_effect_dummy_unlock_gongsun_zan_1	解锁部队：白马义从	true
effects_description_hv_effect_dummy_unlock_guan_yu_1	解锁部队：啮臂军	true
effects_description_hv_effect_dummy_unlock_guo_si_1	解锁部队：平叛义军	true
effects_description_hv_effect_dummy_unlock_han_sui_1	解锁部队：矛兵团	true
effects_description_hv_effect_dummy_unlock_huang_zhong_1	解锁部队：鸱鸮射手	true
effects_description_hv_effect_dummy_unlock_ji_ling_1	解锁部队：斧兵团	true
effects_description_hv_effect_dummy_unlock_jian_yong_1	解锁部队：浪世匠人	true
effects_description_hv_effect_dummy_unlock_kong_rong_1	解锁部队：建安重门戟兵、建安重门弓兵	true
effects_description_hv_effect_dummy_unlock_lady_dong_peishan_1	解锁部队：敛锷军	true
effects_description_hv_effect_dummy_unlock_lady_lu_zheng_1	解锁部队：泰山恶棍、泰山魅影	true
effects_description_hv_effect_dummy_unlock_lady_ma_lanli_1	解锁部队：神鹰军	true
effects_description_hv_effect_dummy_unlock_lady_ma_yunlu_1	解锁部队：神鹰军	true
effects_description_hv_effect_dummy_unlock_lady_sun_1	解锁部队：烈女侍骑	true
effects_description_hv_effect_dummy_unlock_lady_wang_liting_1	解锁部队：浪世匠人	true
effects_description_hv_effect_dummy_unlock_lady_wu_minyu_1	解锁部队：烈女侍骑	true
effects_description_hv_effect_dummy_unlock_lady_yuan_anyang_1	解锁部队：袁氏剑卫、袁氏戟卫	true
effects_description_hv_effect_dummy_unlock_li_jue_1	解锁部队：飞熊军	true
effects_description_hv_effect_dummy_unlock_liu_bei_1	解锁部队：左将军部曲、民兵宿老骑兵、啮臂军	true
effects_description_hv_effect_dummy_unlock_liu_bei_dlc05_1	解锁部队：左将军部曲、民兵宿老骑兵、啮臂军	true
effects_description_hv_effect_dummy_unlock_lu_bu_1	解锁部队：陷阵营、飞熊军	true
effects_description_hv_effect_dummy_unlock_pang_tong_1	解锁部队：鸱鸮射手	true
effects_description_hv_effect_dummy_unlock_sima_yi_1	解锁部队：鸱鸮射手	true
effects_description_hv_effect_dummy_unlock_sun_jian_1	解锁部队：解烦军	true
effects_description_hv_effect_dummy_unlock_sun_ce_1	解锁部队：解烦军	true
effects_description_hv_effect_dummy_unlock_sun_quan_1	解锁部队：解烦军	true
effects_description_hv_effect_dummy_unlock_taishi_ci_1	解锁部队：鸱鸮射手	true
effects_description_hv_effect_dummy_unlock_wang_xiu_1	解锁部队：平叛义军	true
effects_description_hv_effect_dummy_unlock_xu_chu_1	解锁部队：矛兵团	true
effects_description_hv_effect_dummy_unlock_xu_huang_1	解锁部队：斧兵团	true
effects_description_hv_effect_dummy_unlock_xu_shu_1	解锁部队：鸱鸮射手	true
effects_description_hv_effect_dummy_unlock_xun_yu_1	解锁部队：投火弩兵	true
effects_description_hv_effect_dummy_unlock_yan_yu_1	解锁部队：白虎枪兵	true
effects_description_hv_effect_dummy_unlock_yuan_shang_1	解锁部队：袁氏剑卫、袁氏戟卫	true
effects_description_hv_effect_dummy_unlock_yuan_shao_1	解锁部队：先登死士	true
effects_description_hv_effect_dummy_unlock_yuan_shu_1	解锁部队：袁氏剑卫、袁氏戟卫	true
effects_description_hv_effect_dummy_unlock_yuan_tan_1	解锁部队：袁氏剑卫、袁氏戟卫	true
effects_description_hv_effect_dummy_unlock_yuan_xi_1	解锁部队：袁氏剑卫、袁氏戟卫	true
effects_description_hv_effect_dummy_unlock_yue_jin_1	解锁部队：斧兵团	true
effects_description_hv_effect_dummy_unlock_zhang_fei_1	解锁部队：啮臂军	true
effects_description_hv_effect_dummy_unlock_zhang_liao_1	解锁部队：平叛义军	true
effects_description_hv_effect_dummy_unlock_zhang_xun_1	解锁部队	true
effects_description_hv_effect_dummy_unlock_zhang_yan_1	解锁部队：黑山匪徒、黑山猎人	true
effects_description_hv_effect_dummy_unlock_zhao_yun_1	解锁部队：斧兵团	true
effects_description_hv_effect_dummy_unlock_zheng_jiang_1	解锁部队：泰山恶棍、泰山魅影	true
effects_description_hv_effect_dummy_unlock_zhou_yu_1	解锁部队：鸱鸮射手	true
effects_description_hv_effect_dummy_unlock_zhuge_liang_1	解锁部队	true
effects_description_hv_effect_dummy_unlock_cao_bao_1	解锁部队：丹阳兵	true
effects_description_hv_effect_dummy_unlock_generic_house_of_yuan_earth_1	解锁部队：袁氏剑卫、袁氏戟卫	true
effects_description_hv_effect_dummy_unlock_generic_house_of_yuan_metal_1	解锁部队：袁氏剑卫、袁氏戟卫	true
effects_description_hv_effect_dummy_unlock_generic_tao_brothers_metal_1	解锁部队	true
effects_description_hv_effect_dummy_unlock_generic_tao_brothers_wood_1	解锁部队	true
effects_description_hv_effect_dummy_unlock_tao_qian_1	解锁部队：护土枪兵、护土弓兵	true
effects_description_hv_effect_dummy_unlock_zhang_hong_1	解锁部队：浪世匠人	true
effects_description_hv_effect_dummy_unlock_zhang_zhao_1	解锁部队：浪世匠人	true
effects_description_hv_effect_dummy_unlock_yan_liang_1	解锁部队：斧兵团	true
effects_description_hv_effect_dummy_unlock_wen_chou_1	解锁部队：矛兵团	true
effects_description_hv_effect_dummy_unlock_luo_jun_1	解锁部队：护土枪兵、护土弓兵	true
effects_description_hv_effect_dummy_unlock_yan_xiang_1	解锁部队：浪世匠人	true
effects_description_hv_effect_dummy_unlock_guo_jia_2	解锁部队	true
effects_description_hv_effect_dummy_unlock_huang_gai_2	解锁部队	true
effects_description_hv_effect_dummy_unlock_huangfu_song_2	解锁部队：平叛义军	true
effects_description_hv_effect_dummy_unlock_jia_xu_2	解锁部队	true
effects_description_hv_effect_dummy_unlock_lu_zhi_2	解锁部队	true
effects_description_hv_effect_dummy_unlock_prince_liu_chong_2	解锁部队：陈郡羽林军	true
effects_description_hv_effect_dummy_unlock_chen_gong_2	解锁部队	true
effects_description_hv_effect_dummy_unlock_cheng_pu_2	解锁部队	true
effects_description_hv_effect_dummy_unlock_gao_shun_2	解锁部队	true
effects_description_hv_effect_dummy_unlock_yan_baihu_2	解锁部队：白虎精锐勇士	true
effects_description_hv_effect_dummy_unlock_zhou_tai_2	解锁部队	true
effects_description_hv_effect_dummy_unlock_cao_cao_2	解锁部队：虎豹骑	true
effects_description_hv_effect_dummy_unlock_cao_ren_2	解锁部队	true
effects_description_hv_effect_dummy_unlock_dong_min_2	解锁部队	true
effects_description_hv_effect_dummy_unlock_dong_zhuo_2	解锁部队	true
effects_description_hv_effect_dummy_unlock_gan_ning_2	解锁部队：投火弩兵	true
effects_description_hv_effect_dummy_unlock_gongsun_zan_2	解锁部队：铁腕将军护卫	true
effects_description_hv_effect_dummy_unlock_guan_yu_2	解锁部队	true
effects_description_hv_effect_dummy_unlock_guo_si_2	解锁部队	true
effects_description_hv_effect_dummy_unlock_han_sui_2	解锁部队	true
effects_description_hv_effect_dummy_unlock_huang_zhong_2	解锁部队	true
effects_description_hv_effect_dummy_unlock_ji_ling_2	解锁部队	true
effects_description_hv_effect_dummy_unlock_jian_yong_2	解锁部队	true
effects_description_hv_effect_dummy_unlock_kong_rong_2	解锁部队：建安重门骑弩	true
effects_description_hv_effect_dummy_unlock_lady_dong_peishan_2	解锁部队	true
effects_description_hv_effect_dummy_unlock_lady_lu_zheng_2	解锁部队：泰山妖风	true
effects_description_hv_effect_dummy_unlock_lady_ma_lanli_2	解锁部队	true
effects_description_hv_effect_dummy_unlock_lady_ma_yunlu_2	解锁部队	true
effects_description_hv_effect_dummy_unlock_lady_sun_2	解锁部队	true
effects_description_hv_effect_dummy_unlock_lady_wang_liting_2	解锁部队	true
effects_description_hv_effect_dummy_unlock_lady_wu_minyu_2	解锁部队	true
effects_description_hv_effect_dummy_unlock_lady_yuan_anyang_2	解锁部队	true
effects_description_hv_effect_dummy_unlock_li_jue_2	解锁部队	true
effects_description_hv_effect_dummy_unlock_liu_bei_2	解锁部队：白毦兵	true
effects_description_hv_effect_dummy_unlock_liu_bei_dlc05_2	解锁部队：丹阳兵、白毦兵	true
effects_description_hv_effect_dummy_unlock_lu_bu_2	解锁部队	true
effects_description_hv_effect_dummy_unlock_pang_tong_2	解锁部队：投火弩兵	true
effects_description_hv_effect_dummy_unlock_sima_yi_2	解锁部队：投火弩兵	true
effects_description_hv_effect_dummy_unlock_sun_jian_2	解锁部队：青巾军	true
effects_description_hv_effect_dummy_unlock_sun_ce_2	解锁部队：青巾军	true
effects_description_hv_effect_dummy_unlock_sun_quan_2	解锁部队：青巾军	true
effects_description_hv_effect_dummy_unlock_taishi_ci_2	解锁部队	true
effects_description_hv_effect_dummy_unlock_wang_xiu_2	解锁部队	true
effects_description_hv_effect_dummy_unlock_xu_chu_2	解锁部队	true
effects_description_hv_effect_dummy_unlock_xu_huang_2	解锁部队	true
effects_description_hv_effect_dummy_unlock_xu_shu_2	解锁部队	true
effects_description_hv_effect_dummy_unlock_xun_yu_2	解锁部队	true
effects_description_hv_effect_dummy_unlock_yan_yu_2	解锁部队：白虎精锐勇士	true
effects_description_hv_effect_dummy_unlock_yuan_shang_2	解锁部队	true
effects_description_hv_effect_dummy_unlock_yuan_shao_2	解锁部队：袁氏剑卫、袁氏戟卫	true
effects_description_hv_effect_dummy_unlock_yuan_shu_2	解锁部队：仲家铁卫	true
effects_description_hv_effect_dummy_unlock_yuan_tan_2	解锁部队	true
effects_description_hv_effect_dummy_unlock_yuan_xi_2	解锁部队	true
effects_description_hv_effect_dummy_unlock_yue_jin_2	解锁部队	true
effects_description_hv_effect_dummy_unlock_zhang_fei_2	解锁部队	true
effects_description_hv_effect_dummy_unlock_zhang_liao_2	解锁部队	true
effects_description_hv_effect_dummy_unlock_zhang_xun_2	解锁部队	true
effects_description_hv_effect_dummy_unlock_zhang_yan_2	解锁部队	true
effects_description_hv_effect_dummy_unlock_zhao_yun_2	解锁部队	true
effects_description_hv_effect_dummy_unlock_zheng_jiang_2	解锁部队：泰山妖风	true
effects_description_hv_effect_dummy_unlock_zhou_yu_2	解锁部队：投火弩兵	true
effects_description_hv_effect_dummy_unlock_zhuge_liang_2	解锁部队：投火弩兵	true
effects_description_hv_effect_dummy_unlock_cao_bao_2	解锁部队	true
effects_description_hv_effect_dummy_unlock_generic_house_of_yuan_earth_2	解锁部队：袁氏剑卫、袁氏戟卫	true
effects_description_hv_effect_dummy_unlock_generic_house_of_yuan_metal_2	解锁部队：袁氏剑卫、袁氏戟卫	true
effects_description_hv_effect_dummy_unlock_generic_tao_brothers_metal_2	解锁部队	true
effects_description_hv_effect_dummy_unlock_generic_tao_brothers_wood_2	解锁部队	true
effects_description_hv_effect_dummy_unlock_tao_qian_2	解锁部队：丹阳兵	true
effects_description_hv_effect_dummy_unlock_zhang_hong_2	解锁部队	true
effects_description_hv_effect_dummy_unlock_zhang_zhao_2	解锁部队	true
effects_description_hv_effect_dummy_unlock_yan_liang_2	解锁部队	true
effects_description_hv_effect_dummy_unlock_wen_chou_2	解锁部队	true
effects_description_hv_effect_dummy_unlock_luo_jun_2	解锁部队：平叛义军	true
effects_description_hv_effect_dummy_unlock_yan_xiang_2	解锁部队	true
effects_description_hv_effect_dummy_unlock_guo_jia_3	解锁部队	true
effects_description_hv_effect_dummy_unlock_huang_gai_3	解锁部队	true
effects_description_hv_effect_dummy_unlock_huangfu_song_3	解锁部队	true
effects_description_hv_effect_dummy_unlock_jia_xu_3	解锁部队	true
effects_description_hv_effect_dummy_unlock_lu_zhi_3	解锁部队	true
effects_description_hv_effect_dummy_unlock_prince_liu_chong_3	解锁部队	true
effects_description_hv_effect_dummy_unlock_chen_gong_3	解锁部队	true
effects_description_hv_effect_dummy_unlock_cheng_pu_3	解锁部队	true
effects_description_hv_effect_dummy_unlock_gao_shun_3	解锁部队	true
effects_description_hv_effect_dummy_unlock_yan_baihu_3	解锁部队	true
effects_description_hv_effect_dummy_unlock_zhou_tai_3	解锁部队	true
effects_description_hv_effect_dummy_unlock_cao_cao_3	解锁部队	true
effects_description_hv_effect_dummy_unlock_cao_ren_3	解锁部队	true
effects_description_hv_effect_dummy_unlock_dong_min_3	解锁部队	true
effects_description_hv_effect_dummy_unlock_dong_zhuo_3	解锁部队	true
effects_description_hv_effect_dummy_unlock_gan_ning_3	解锁部队	true
effects_description_hv_effect_dummy_unlock_gongsun_zan_3	解锁部队	true
effects_description_hv_effect_dummy_unlock_guan_yu_3	解锁部队	true
effects_description_hv_effect_dummy_unlock_guo_si_3	解锁部队	true
effects_description_hv_effect_dummy_unlock_han_sui_3	解锁部队	true
effects_description_hv_effect_dummy_unlock_huang_zhong_3	解锁部队	true
effects_description_hv_effect_dummy_unlock_ji_ling_3	解锁部队	true
effects_description_hv_effect_dummy_unlock_jian_yong_3	解锁部队	true
effects_description_hv_effect_dummy_unlock_kong_rong_3	解锁部队	true
effects_description_hv_effect_dummy_unlock_lady_dong_peishan_3	解锁部队	true
effects_description_hv_effect_dummy_unlock_lady_lu_zheng_3	解锁部队：魁首前军	true
effects_description_hv_effect_dummy_unlock_lady_ma_lanli_3	解锁部队	true
effects_description_hv_effect_dummy_unlock_lady_ma_yunlu_3	解锁部队	true
effects_description_hv_effect_dummy_unlock_lady_sun_3	解锁部队	true
effects_description_hv_effect_dummy_unlock_lady_wang_liting_3	解锁部队	true
effects_description_hv_effect_dummy_unlock_lady_wu_minyu_3	解锁部队	true
effects_description_hv_effect_dummy_unlock_lady_yuan_anyang_3	解锁部队	true
effects_description_hv_effect_dummy_unlock_li_jue_3	解锁部队	true
effects_description_hv_effect_dummy_unlock_liu_bei_3	解锁部队	true
effects_description_hv_effect_dummy_unlock_liu_bei_dlc05_3	解锁部队	true
effects_description_hv_effect_dummy_unlock_lu_bu_3	解锁部队	true
effects_description_hv_effect_dummy_unlock_pang_tong_3	解锁部队	true
effects_description_hv_effect_dummy_unlock_sima_yi_3	解锁部队	true
effects_description_hv_effect_dummy_unlock_sun_jian_3	解锁部队	true
effects_description_hv_effect_dummy_unlock_sun_ce_3	解锁部队	true
effects_description_hv_effect_dummy_unlock_sun_quan_3	解锁部队	true
effects_description_hv_effect_dummy_unlock_taishi_ci_3	解锁部队	true
effects_description_hv_effect_dummy_unlock_wang_xiu_3	解锁部队	true
effects_description_hv_effect_dummy_unlock_xu_chu_3	解锁部队	true
effects_description_hv_effect_dummy_unlock_xu_huang_3	解锁部队	true
effects_description_hv_effect_dummy_unlock_xu_shu_3	解锁部队	true
effects_description_hv_effect_dummy_unlock_xun_yu_3	解锁部队	true
effects_description_hv_effect_dummy_unlock_yan_yu_3	解锁部队	true
effects_description_hv_effect_dummy_unlock_yuan_shang_3	解锁部队	true
effects_description_hv_effect_dummy_unlock_yuan_shao_3	解锁部队	true
effects_description_hv_effect_dummy_unlock_yuan_shu_3	解锁部队	true
effects_description_hv_effect_dummy_unlock_yuan_tan_3	解锁部队	true
effects_description_hv_effect_dummy_unlock_yuan_xi_3	解锁部队	true
effects_description_hv_effect_dummy_unlock_yue_jin_3	解锁部队	true
effects_description_hv_effect_dummy_unlock_zhang_fei_3	解锁部队	true
effects_description_hv_effect_dummy_unlock_zhang_liao_3	解锁部队	true
effects_description_hv_effect_dummy_unlock_zhang_xun_3	解锁部队	true
effects_description_hv_effect_dummy_unlock_zhang_yan_3	解锁部队	true
effects_description_hv_effect_dummy_unlock_zhao_yun_3	解锁部队	true
effects_description_hv_effect_dummy_unlock_zheng_jiang_3	解锁部队：魁首前军	true
effects_description_hv_effect_dummy_unlock_zhou_yu_3	解锁部队	true
effects_description_hv_effect_dummy_unlock_zhuge_liang_3	解锁部队	true
effects_description_hv_effect_dummy_unlock_cao_bao_3	解锁部队	true
effects_description_hv_effect_dummy_unlock_generic_house_of_yuan_earth_3	解锁部队	true
effects_description_hv_effect_dummy_unlock_generic_house_of_yuan_metal_3	解锁部队	true
effects_description_hv_effect_dummy_unlock_generic_tao_brothers_metal_3	解锁部队：丹阳兵	true
effects_description_hv_effect_dummy_unlock_generic_tao_brothers_wood_3	解锁部队：丹阳兵	true
effects_description_hv_effect_dummy_unlock_tao_qian_3	解锁部队	true
effects_description_hv_effect_dummy_unlock_zhang_hong_3	解锁部队	true
effects_description_hv_effect_dummy_unlock_zhang_zhao_3	解锁部队	true
effects_description_hv_effect_dummy_unlock_yan_liang_3	解锁部队	true
effects_description_hv_effect_dummy_unlock_wen_chou_3	解锁部队	true
effects_description_hv_effect_dummy_unlock_luo_jun_3	解锁部队	true
effects_description_hv_effect_dummy_unlock_yan_xiang_3	解锁部队	true
effects_description_hv_effect_dummy_unlock_house_yuan_1	解锁部队：袁氏剑卫、袁氏戟卫	true
effects_description_hv_effect_dummy_unlock_house_yuan_2	解锁部队	true
effects_description_hv_effect_dummy_unlock_house_yuan_3	解锁部队	true
effects_description_hv_effect_dummy_unlock_house_tao_1	解锁部队：丹阳兵	true
effects_description_hv_effect_dummy_unlock_house_tao_2	解锁部队	true
effects_description_hv_effect_dummy_unlock_house_tao_3	解锁部队	true
