key	text	tooltip
#Loc;1;text/!@hv_TEXT_UNIT_NEW.loc		
land_units_onscreen_name_hv_unit_peasant_mob	农民斧兵	true
land_units_onscreen_name_hv_unit_peasant_spearmen	农民矛兵	true
land_units_onscreen_name_hv_unit_militia_sabre	持刀民兵	true
land_units_onscreen_name_hv_unit_militia_spearmen	持矛民兵	true
land_units_onscreen_name_hv_unit_militia_archers	持弓民兵	true
land_units_onscreen_name_hv_unit_strays_spearmen	应征矛兵	true
land_units_onscreen_name_hv_unit_strays_arhcers	应征弓兵	true
land_units_onscreen_name_hv_unit_strays_cavalry	应征骑兵	true
land_units_onscreen_name_hv_unit_regular_sabre	持剑材官	true
land_units_onscreen_name_hv_unit_regular_spearmen	持枪材官	true
land_units_onscreen_name_hv_unit_regular_archers	引强材官	true
land_units_onscreen_name_hv_unit_regular_crossbowmen	积射材官	true
land_units_onscreen_name_hv_unit_regular_repeating_crossbowmen	连弩积射材官	true
land_units_onscreen_name_hv_unit_regular_ji	持戟材官	true
land_units_onscreen_name_hv_unit_regular_sabre_cavalry	佩剑屯骑	true
land_units_onscreen_name_hv_unit_regular_lance_cavalry	持枪骑兵	true
land_units_onscreen_name_hv_unit_beihai_sabre	郡国剑卫	true
land_units_onscreen_name_hv_unit_beihai_assault_cavalry	郡国突击骑兵	true
land_units_onscreen_name_hv_unit_beihai_spearmen	郡国枪兵	true
land_units_onscreen_name_hv_unit_beihai_ji	郡国戟卫	true
land_units_onscreen_name_hv_unit_beihai_crossbowmen	郡国弩兵	true
land_units_onscreen_name_hv_unit_beihai_repeating_crossbowmen	郡国连弩兵	true
land_units_onscreen_name_hv_unit_xiliang_repeating_crossbowmen	西凉连弩兵	true
land_units_onscreen_name_hv_unit_xiliang_sabre_cavalry	西凉马刀骑兵	true
land_units_onscreen_name_hv_unit_xiliang_spear_cavalry	西凉枪骑兵	true
land_units_onscreen_name_hv_unit_xiliang_ji	西凉戟卫	true
land_units_onscreen_name_hv_unit_xiliang_crossbowmen	西凉弩兵	true
land_units_onscreen_name_hv_unit_xiliang_assault	西凉突击步兵	true
land_units_onscreen_name_hv_unit_xiliang_mounted_archers	西凉马弓手	true
land_units_onscreen_name_hv_unit_jing_axemen	荆州斧兵	true
land_units_onscreen_name_hv_unit_jing_archers	荆州弓兵	true
land_units_onscreen_name_hv_unit_jing_long_swordmen	荆州偃月刀手	true
land_units_onscreen_name_hv_unit_jing_spearmen	荆州枪兵	true
land_units_onscreen_name_hv_unit_jing_sabre_cavalry	荆州马刀骑兵	true
land_units_onscreen_name_hv_unit_bandit_axemen	盗匪斧兵	true
land_units_onscreen_name_hv_unit_bandit_long_axemen	盗匪长斧兵	true
land_units_onscreen_name_hv_unit_bandit_long_spearmen	盗匪长枪兵	true
land_units_onscreen_name_hv_unit_bandit_archers	盗匪弓兵	true
land_units_onscreen_name_hv_unit_warlord_elite_swordsmen	州牧精锐剑卫	true
land_units_onscreen_name_hv_unit_warlord_elite_long_swordsmen	州牧精锐斩马劲卒	true
land_units_onscreen_name_hv_unit_warlord_elite_ji	州牧精锐戟卫	true
land_units_onscreen_name_hv_unit_warlord_elite_lance_cavalry	州牧精锐重装铁骑	true
land_units_onscreen_name_hv_unit_beihai_elite_spearmen	郡国精锐枪卫	true
land_units_onscreen_name_hv_unit_beihai_elite_halberdiers	郡国精锐重戟卫士	true
land_units_onscreen_name_hv_unit_beihai_elite_crossobwmen	郡国精锐弩兵	true
land_units_onscreen_name_hv_unit_beihai_elite_repeating_crossobwmen	郡国精锐连弩兵	true
land_units_onscreen_name_hv_unit_xiliang_stalwarts_lance_cavalry	陇西精锐枪骑兵	true
land_units_onscreen_name_hv_unit_xiliang_stalwarts_long_spearmen	陇西精锐长枪卫士	true
land_units_onscreen_name_hv_unit_xiliang_rapid_bear_infantry	关中精锐铁锤战士	true
land_units_onscreen_name_hv_unit_xiliang_elite_halberdiers	关中精锐重戟卫士	true
land_units_onscreen_name_hv_unit_xiliang_elite_enforcers	关中精锐护卫	true
land_units_onscreen_name_hv_unit_jing_elite_long_axemen	荆州精锐长斧卫士	true
land_units_onscreen_name_hv_unit_jing_elite_spearmen	荆州精锐枪卫	true
land_units_onscreen_name_hv_unit_jing_elite_heavy_bowmen	荆州精锐重弓手	true
land_units_onscreen_name_hv_unit_double_blades	双刃力士	true
land_units_onscreen_name_hv_unit_iron_walls	铁壁军	true
land_units_onscreen_name_hv_unit_rapid_monkeys	狡猿猎手	true
land_units_onscreen_name_hv_unit_imperial_assault_cavalry	禁军突击骑兵	true
land_units_onscreen_name_hv_unit_imperial_swordsmen	禁军剑卫	true
land_units_onscreen_name_hv_unit_imperial_halberdier	禁军重戟卫士	true
land_units_onscreen_name_hv_unit_imperial_firelancer	禁军火枪营	true
land_units_onscreen_name_hv_unit_imperial_lance_cavalry	禁军重装铁骑	true
land_units_onscreen_name_hv_unit_yellow_dragons	黄龙军	true
land_units_onscreen_name_hv_unit_azure_dragons	青龙军	true
land_units_onscreen_name_hv_unit_pearl_dragons	白龙军	true
land_units_onscreen_name_hv_unit_onyx_dragons	黑龙军	true
land_units_onscreen_name_hv_unit_jade_dragons	玉龙军	true
land_units_onscreen_name_hv_unit_protectors_of_heaven	乾天卫军	true
land_units_onscreen_name_hv_unit_defenders_of_earth	坤地护军	true
land_units_onscreen_name_hv_unit_qiang_axemen	羌人斧兵	true
land_units_onscreen_name_hv_unit_qiang_archers	羌人射手	true
land_units_onscreen_name_hv_unit_qiang_spearmen	羌人枪兵	true
land_units_onscreen_name_hv_unit_qiang_radier_cavalry	羌人突击骑兵	true
land_units_onscreen_name_hv_unit_qiang_mounted_warriors	羌人精锐骑兵	true
land_units_onscreen_name_hv_unit_qiang_mounted_rangers	羌人精锐马弓手	true
land_units_onscreen_name_hv_unit_wu_huan_cavalry	乌桓骑兵	true
land_units_onscreen_name_hv_unit_barded_wu_huan_cavalry	乌桓铁骑	true
land_units_onscreen_name_hv_unit_xiongnu_warriors	匈奴勇士	true
land_units_onscreen_name_hv_unit_xiongnu_cataphracts	匈奴铁骑	true
land_units_onscreen_name_hv_unit_xiongnu_mounted_archers	匈奴马弓手	true
land_units_onscreen_name_hv_unit_sogd_warriors	粟特勇士	true
land_units_onscreen_name_hv_unit_xionite_cavalry	粟特铁骑	true
land_units_onscreen_name_hv_unit_shan_yue_warriors	山越勇士	true
land_units_onscreen_name_hv_unit_shan_yue_archers	山越射手	true
land_units_onscreen_name_hv_unit_yue_remnants	越人遗民	true
land_units_onscreen_name_hv_unit_wulingman_long_axemen	武陵蛮勇士	true
land_units_onscreen_name_hv_unit_wulingman_archers	武陵蛮射手	true
land_units_onscreen_name_hv_unit_trebuchet_ytr	霹雳车	true
land_units_onscreen_name_hv_unit_trebuchet_bastion	霹雳车	true
land_units_onscreen_name_hv_unit_trebuchet	霹雳车	true
land_units_onscreen_name_hv_unit_multiple_bolt_crossbow_ytr	连发巨弩	true
land_units_onscreen_name_hv_unit_multiple_bolt_crossbow	连发巨弩	true
land_units_onscreen_name_hv_unit_multiple_bolt_crossbow_bastion	连发巨弩	true
land_units_onscreen_name_hv_unit_qingzhou_long_axemen	青州长斧兵	true
land_units_onscreen_name_hv_unit_qingzhou_infantry	青州手戟步兵	true
land_units_onscreen_name_hv_unit_tiger_leopard_cavalry	虎豹骑	true
land_units_onscreen_name_hv_unit_buqu_of_left	左将军部曲	true
land_units_onscreen_name_hv_unit_mounted_scouts	民兵宿老骑兵	true
land_units_onscreen_name_hv_unit_fellows_of_the_oath	啮臂军	true
land_units_onscreen_name_hv_unit_white_feathers	白毦兵	true
land_units_onscreen_name_hv_unit_jei_fan	解烦兵	true
land_units_onscreen_name_hv_unit_blue_turbans	青巾军	true
land_units_onscreen_name_hv_unit_female_guards	烈女侍骑	true
land_units_onscreen_name_hv_unit_house_of_yuan_ji	袁氏戟卫	true
land_units_onscreen_name_hv_unit_house_of_yuan_swordsmen	袁氏剑卫	true
land_units_onscreen_name_hv_unit_porcupine_crossbowmen	先登死士	true
land_units_onscreen_name_hv_unit_iron_zhong_royal_guards	仲家铁卫	true
land_units_onscreen_name_hv_unit_white_horse_fellows	白马义从	true
land_units_onscreen_name_hv_unit_iron_fists_officers	铁腕将军护卫	true
land_units_onscreen_name_hv_unit_xiliang_elite_barded_cavalry	飞熊军	true
land_units_onscreen_name_hv_unit_xian_chen_ying	陷阵营	true
land_units_onscreen_name_hv_unit_beihai_guards	建安重门戟兵	true
land_units_onscreen_name_hv_unit_beihai_mounted_crossbowmen	建安重门骑弩	true
land_units_onscreen_name_hv_unit_xuzhou_archers	护土弓兵	true
land_units_onscreen_name_hv_unit_xuzhou_guardsmen	护土枪兵	true
land_units_onscreen_name_hv_unit_dan_yang_infantry	丹阳兵	true
land_units_onscreen_name_hv_unit_goshawk_cavalry	神鹰军	true
land_units_onscreen_name_hv_unit_fire_bomber	投火弩兵	true
land_units_onscreen_name_hv_unit_yuan_rong_crossbowmen	元戎弩兵	true
land_units_onscreen_name_hv_unit_southern_assault	敛锷军	true
land_units_onscreen_name_hv_unit_chen_peacekeepers	陈郡泰平卫士	true
land_units_onscreen_name_hv_unit_chen_royal_horseguards	陈郡羽林军	true
land_units_onscreen_name_hv_unit_taishan_archers_lime	泰山妖风	true
land_units_onscreen_name_hv_unit_taishan_assault	泰山魅影	true
land_units_onscreen_name_hv_unit_taishan_batters	泰山恶棍	true
land_units_onscreen_name_hv_unit_fists_of_bandit_queen	魁首前军	true
land_units_onscreen_name_hv_unit_black_mountain_bandits	黑山匪徒	true
land_units_onscreen_name_hv_unit_black_mountain_hunters	黑山猎人	true
land_units_onscreen_name_hv_unit_black_mountain_cavalry	黑山骑兵	true
land_units_onscreen_name_hv_unit_white_tiger_warriors	白虎精锐勇士	true
land_units_onscreen_name_hv_unit_white_tiger_spearmen	白虎枪兵	true
land_units_onscreen_name_hv_unit_sabre_guardsmen	佩刀卫士	true
land_units_onscreen_name_hv_unit_archers_guardsmen	持弓卫士	true
land_units_onscreen_name_hv_unit_ji_guardsmen	持戟卫士	true
land_units_onscreen_name_hv_unit_mercenary_captain	雇佣伯长	true
land_units_onscreen_name_hv_unit_yuan_shao_captain	袁氏护军	true
land_units_onscreen_name_hv_unit_han_settlement_captain	戍卫伯长	true
land_units_onscreen_name_hv_unit_ytr_settlement_captain	黄巾军戍卫伯长	true
unit_description_short_texts_text_hv_unit_peasant_mob	第一阶 - 志愿乡勇	true
unit_description_short_texts_text_hv_unit_peasant_spearmen	第一阶 - 志愿乡勇	true
unit_description_short_texts_text_hv_unit_militia_sabre	第一阶 - 义勇民兵	true
unit_description_short_texts_text_hv_unit_militia_spearmen	第一阶 - 义勇民兵	true
unit_description_short_texts_text_hv_unit_militia_archers	第一阶 - 义勇民兵	true
unit_description_short_texts_text_hv_unit_strays_spearmen	第一阶 - 应征流民	true
unit_description_short_texts_text_hv_unit_strays_arhcers	第一阶 - 应征流民	true
unit_description_short_texts_text_hv_unit_strays_cavalry	第一阶 - 应征流民	true
unit_description_short_texts_text_hv_unit_regular_sabre	第二阶 - 地方材官	true
unit_description_short_texts_text_hv_unit_regular_spearmen	第二阶 - 地方材官	true
unit_description_short_texts_text_hv_unit_regular_archers	第二阶 - 地方材官	true
unit_description_short_texts_text_hv_unit_regular_crossbowmen	第二阶 - 地方材官	true
unit_description_short_texts_text_hv_unit_regular_repeating_crossbowmen	第二阶 - 地方材官	true
unit_description_short_texts_text_hv_unit_regular_ji	第二阶 - 地方材官	true
unit_description_short_texts_text_hv_unit_regular_sabre_cavalry	第二阶 - 地方材官	true
unit_description_short_texts_text_hv_unit_regular_lance_cavalry	第二阶 - 地方材官	true
unit_description_short_texts_text_hv_unit_beihai_sabre	第二阶 - 地方材官	true
unit_description_short_texts_text_hv_unit_beihai_assault_cavalry	第二阶 - 地方材官	true
unit_description_short_texts_text_hv_unit_beihai_spearmen	第二阶 - 地方材官	true
unit_description_short_texts_text_hv_unit_beihai_ji	第二阶 - 地方材官	true
unit_description_short_texts_text_hv_unit_beihai_crossbowmen	第二阶 - 地方材官	true
unit_description_short_texts_text_hv_unit_beihai_repeating_crossbowmen	第二阶 - 地方材官	true
unit_description_short_texts_text_hv_unit_xiliang_repeating_crossbowmen	第二阶 - 地方材官	true
unit_description_short_texts_text_hv_unit_xiliang_sabre_cavalry	第二阶 - 地方材官	true
unit_description_short_texts_text_hv_unit_xiliang_spear_cavalry	第二阶 - 地方材官	true
unit_description_short_texts_text_hv_unit_xiliang_ji	第二阶 - 地方材官	true
unit_description_short_texts_text_hv_unit_xiliang_crossbowmen	第二阶 - 地方材官	true
unit_description_short_texts_text_hv_unit_xiliang_assault	第二阶 - 地方材官	true
unit_description_short_texts_text_hv_unit_xiliang_mounted_archers	第二阶 - 地方材官	true
unit_description_short_texts_text_hv_unit_jing_axemen	第二阶 - 地方材官	true
unit_description_short_texts_text_hv_unit_jing_archers	第二阶 - 地方材官	true
unit_description_short_texts_text_hv_unit_jing_long_swordmen	第二阶 - 地方材官	true
unit_description_short_texts_text_hv_unit_jing_spearmen	第二阶 - 地方材官	true
unit_description_short_texts_text_hv_unit_jing_sabre_cavalry	第二阶 - 地方材官	true
unit_description_short_texts_text_hv_unit_bandit_axemen	第二阶 - 地方材官	true
unit_description_short_texts_text_hv_unit_bandit_long_axemen	第二阶 - 地方材官	true
unit_description_short_texts_text_hv_unit_bandit_long_spearmen	第二阶 - 地方材官	true
unit_description_short_texts_text_hv_unit_bandit_archers	第二阶 - 地方材官	true
unit_description_short_texts_text_hv_unit_warlord_elite_swordsmen	第三阶 - 精锐部队	true
unit_description_short_texts_text_hv_unit_warlord_elite_long_swordsmen	第三阶 - 精锐部队	true
unit_description_short_texts_text_hv_unit_warlord_elite_ji	第三阶 - 精锐部队	true
unit_description_short_texts_text_hv_unit_warlord_elite_lance_cavalry	第三阶 - 精锐部队	true
unit_description_short_texts_text_hv_unit_beihai_elite_spearmen	第三阶 - 精锐部队	true
unit_description_short_texts_text_hv_unit_beihai_elite_halberdiers	第三阶 - 精锐部队	true
unit_description_short_texts_text_hv_unit_beihai_elite_crossobwmen	第三阶 - 精锐部队	true
unit_description_short_texts_text_hv_unit_beihai_elite_repeating_crossobwmen	第三阶 - 精锐部队	true
unit_description_short_texts_text_hv_unit_xiliang_stalwarts_lance_cavalry	第三阶 - 精锐部队	true
unit_description_short_texts_text_hv_unit_xiliang_stalwarts_long_spearmen	第三阶 - 精锐部队	true
unit_description_short_texts_text_hv_unit_xiliang_rapid_bear_infantry	第三阶 - 精锐部队	true
unit_description_short_texts_text_hv_unit_xiliang_elite_halberdiers	第三阶 - 精锐部队	true
unit_description_short_texts_text_hv_unit_xiliang_elite_enforcers	第三阶 - 精锐部队	true
unit_description_short_texts_text_hv_unit_jing_elite_long_axemen	第三阶 - 精锐部队	true
unit_description_short_texts_text_hv_unit_jing_elite_spearmen	第三阶 - 精锐部队	true
unit_description_short_texts_text_hv_unit_jing_elite_heavy_bowmen	第三阶 - 精锐部队	true
unit_description_short_texts_text_hv_unit_double_blades	第三阶 - 精锐部队	true
unit_description_short_texts_text_hv_unit_iron_walls	第三阶 - 精锐部队	true
unit_description_short_texts_text_hv_unit_rapid_monkeys	第三阶 - 精锐部队	true
unit_description_short_texts_text_hv_unit_imperial_assault_cavalry	第四阶 - 禁军	true
unit_description_short_texts_text_hv_unit_imperial_swordsmen	第四阶 - 禁军	true
unit_description_short_texts_text_hv_unit_imperial_halberdier	第四阶 - 禁军	true
unit_description_short_texts_text_hv_unit_imperial_firelancer	第四阶 - 禁军	true
unit_description_short_texts_text_hv_unit_imperial_lance_cavalry	第四阶 - 禁军	true
unit_description_short_texts_text_hv_unit_yellow_dragons	第四阶 - 禁军	true
unit_description_short_texts_text_hv_unit_azure_dragons	第四阶 - 禁军	true
unit_description_short_texts_text_hv_unit_pearl_dragons	第四阶 - 禁军	true
unit_description_short_texts_text_hv_unit_onyx_dragons	第四阶 - 禁军	true
unit_description_short_texts_text_hv_unit_jade_dragons	第四阶 - 禁军	true
unit_description_short_texts_text_hv_unit_protectors_of_heaven	第四阶 - 禁军	true
unit_description_short_texts_text_hv_unit_defenders_of_earth	第四阶 - 禁军	true
unit_description_short_texts_text_hv_unit_qiang_axemen	第二阶 - 地方材官	true
unit_description_short_texts_text_hv_unit_qiang_archers	第二阶 - 地方材官	true
unit_description_short_texts_text_hv_unit_qiang_spearmen	第二阶 - 地方材官	true
unit_description_short_texts_text_hv_unit_qiang_radier_cavalry	第二阶 - 地方材官	true
unit_description_short_texts_text_hv_unit_qiang_mounted_warriors	第三阶 - 精锐部队	true
unit_description_short_texts_text_hv_unit_qiang_mounted_rangers	第三阶 - 精锐部队	true
unit_description_short_texts_text_hv_unit_wu_huan_cavalry	第二阶 - 地方材官	true
unit_description_short_texts_text_hv_unit_barded_wu_huan_cavalry	第三阶 - 精锐部队	true
unit_description_short_texts_text_hv_unit_xiongnu_warriors	第二阶 - 地方材官	true
unit_description_short_texts_text_hv_unit_xiongnu_cataphracts	第三阶 - 精锐部队	true
unit_description_short_texts_text_hv_unit_xiongnu_mounted_archers	第三阶 - 精锐部队	true
unit_description_short_texts_text_hv_unit_sogd_warriors	第三阶 - 精锐部队	true
unit_description_short_texts_text_hv_unit_xionite_cavalry	第三阶 - 精锐部队	true
unit_description_short_texts_text_hv_unit_shan_yue_warriors	第二阶 - 地方材官	true
unit_description_short_texts_text_hv_unit_shan_yue_archers	第二阶 - 地方材官	true
unit_description_short_texts_text_hv_unit_yue_remnants	第三阶 - 精锐部队	true
unit_description_short_texts_text_hv_unit_wulingman_long_axemen	第二阶 - 地方材官	true
unit_description_short_texts_text_hv_unit_wulingman_archers	第二阶 - 地方材官	true
unit_description_short_texts_text_hv_unit_trebuchet_bastion	第二阶 - 地方材官	true
unit_description_short_texts_text_hv_unit_trebuchet	第二阶 - 地方材官	true
unit_description_short_texts_text_hv_unit_multiple_bolt_crossbow	第二阶 - 地方材官	true
unit_description_short_texts_text_hv_unit_multiple_bolt_crossbow_bastion	第二阶 - 地方材官	true
unit_description_short_texts_text_hv_unit_qingzhou_long_axemen	第二阶 - 地方材官	true
unit_description_short_texts_text_hv_unit_qingzhou_infantry	第二阶 - 地方材官	true
unit_description_short_texts_text_hv_unit_tiger_leopard_cavalry	第三阶 - 精锐部队	true
unit_description_short_texts_text_hv_unit_buqu_of_left	第一阶 - 义勇民兵	true
unit_description_short_texts_text_hv_unit_mounted_scouts	第一阶 - 义勇民兵	true
unit_description_short_texts_text_hv_unit_fellows_of_the_oath	第二阶 - 地方材官	true
unit_description_short_texts_text_hv_unit_white_feathers	第三阶 - 精锐部队	true
unit_description_short_texts_text_hv_unit_jei_fan	第二阶 - 地方材官	true
unit_description_short_texts_text_hv_unit_blue_turbans	第三阶 - 精锐部队	true
unit_description_short_texts_text_hv_unit_female_guards	第三阶 - 精锐部队	true
unit_description_short_texts_text_hv_unit_house_of_yuan_ji	第三阶 - 精锐部队	true
unit_description_short_texts_text_hv_unit_house_of_yuan_swordsmen	第三阶 - 精锐部队	true
unit_description_short_texts_text_hv_unit_porcupine_crossbowmen	第二阶 - 地方材官	true
unit_description_short_texts_text_hv_unit_iron_zhong_royal_guards	第四阶 - 禁军	true
unit_description_short_texts_text_hv_unit_white_horse_fellows	第三阶 - 精锐部队	true
unit_description_short_texts_text_hv_unit_iron_fists_officers	第三阶 - 精锐部队	true
unit_description_short_texts_text_hv_unit_xiliang_elite_barded_cavalry	第三阶 - 精锐部队	true
unit_description_short_texts_text_hv_unit_xian_chen_ying	第三阶 - 精锐部队	true
unit_description_short_texts_text_hv_unit_beihai_guards	第二阶 - 地方材官	true
unit_description_short_texts_text_hv_unit_beihai_mounted_crossbowmen	第二阶 - 地方材官	true
unit_description_short_texts_text_hv_unit_xuzhou_archers	第二阶 - 地方材官	true
unit_description_short_texts_text_hv_unit_xuzhou_guardsmen	第二阶 - 地方材官	true
unit_description_short_texts_text_hv_unit_dan_yang_infantry	第三阶 - 精锐部队	true
unit_description_short_texts_text_hv_unit_goshawk_cavalry	第二阶 - 地方材官	true
unit_description_short_texts_text_hv_unit_fire_bomber	第二阶 - 地方材官	true
unit_description_short_texts_text_hv_unit_yuan_rong_crossbowmen	第二阶 - 地方材官	true
unit_description_short_texts_text_hv_unit_southern_assault	第二阶 - 地方材官	true
unit_description_short_texts_text_hv_unit_chen_peacekeepers	第三阶 - 精锐部队	true
unit_description_short_texts_text_hv_unit_chen_royal_horseguards	第四阶 - 禁军	true
unit_description_short_texts_text_hv_unit_taishan_archers_lime	第二阶 - 地方材官	true
unit_description_short_texts_text_hv_unit_taishan_assault	第二阶 - 地方材官	true
unit_description_short_texts_text_hv_unit_taishan_batters	第一阶 - 应征流民	true
unit_description_short_texts_text_hv_unit_fists_of_bandit_queen	第三阶 - 精锐部队	true
unit_description_short_texts_text_hv_unit_black_mountain_bandits	第二阶 - 地方材官	true
unit_description_short_texts_text_hv_unit_black_mountain_hunters	第二阶 - 地方材官	true
unit_description_short_texts_text_hv_unit_black_mountain_cavalry	第三阶 - 精锐部队	true
unit_description_short_texts_text_hv_unit_white_tiger_warriors	第二阶 - 地方材官	true
unit_description_short_texts_text_hv_unit_white_tiger_spearmen	第三阶 - 精锐部队	true
unit_description_short_texts_text_hv_unit_sabre_guardsmen	第二阶 - 地方材官	true
unit_description_short_texts_text_hv_unit_archers_guardsmen	第二阶 - 地方材官	true
unit_description_short_texts_text_hv_unit_ji_guardsmen	第二阶 - 地方材官	true
unit_description_short_texts_text_hv_unit_mercenary_captain	第四阶 - 伯长	true
unit_description_short_texts_text_hv_unit_yuan_shao_captain	第四阶 - 伯长	true
unit_description_short_texts_text_hv_unit_han_settlement_captain	第四阶 - 伯长	true
unit_description_short_texts_text_hv_unit_ytr_settlement_captain	第四阶 - 伯长	true
unit_description_historical_texts_text_hv_unit_peasant_mob		true
unit_description_historical_texts_text_hv_unit_peasant_spearmen		true
unit_description_historical_texts_text_hv_unit_militia_sabre		true
unit_description_historical_texts_text_hv_unit_militia_spearmen		true
unit_description_historical_texts_text_hv_unit_militia_archers		true
unit_description_historical_texts_text_hv_unit_strays_spearmen		true
unit_description_historical_texts_text_hv_unit_strays_arhcers		true
unit_description_historical_texts_text_hv_unit_strays_cavalry		true
unit_description_historical_texts_text_hv_unit_regular_sabre		true
unit_description_historical_texts_text_hv_unit_regular_spearmen		true
unit_description_historical_texts_text_hv_unit_regular_archers		true
unit_description_historical_texts_text_hv_unit_regular_crossbowmen		true
unit_description_historical_texts_text_hv_unit_regular_repeating_crossbowmen		true
unit_description_historical_texts_text_hv_unit_regular_ji		true
unit_description_historical_texts_text_hv_unit_regular_sabre_cavalry		true
unit_description_historical_texts_text_hv_unit_regular_lance_cavalry		true
unit_description_historical_texts_text_hv_unit_beihai_sabre		true
unit_description_historical_texts_text_hv_unit_beihai_assault_cavalry		true
unit_description_historical_texts_text_hv_unit_beihai_spearmen		true
unit_description_historical_texts_text_hv_unit_beihai_ji		true
unit_description_historical_texts_text_hv_unit_beihai_crossbowmen		true
unit_description_historical_texts_text_hv_unit_beihai_repeating_crossbowmen		true
unit_description_historical_texts_text_hv_unit_xiliang_repeating_crossbowmen		true
unit_description_historical_texts_text_hv_unit_xiliang_sabre_cavalry		true
unit_description_historical_texts_text_hv_unit_xiliang_spear_cavalry		true
unit_description_historical_texts_text_hv_unit_xiliang_ji		true
unit_description_historical_texts_text_hv_unit_xiliang_crossbowmen		true
unit_description_historical_texts_text_hv_unit_xiliang_assault		true
unit_description_historical_texts_text_hv_unit_xiliang_mounted_archers		true
unit_description_historical_texts_text_hv_unit_jing_axemen		true
unit_description_historical_texts_text_hv_unit_jing_archers		true
unit_description_historical_texts_text_hv_unit_jing_long_swordmen		true
unit_description_historical_texts_text_hv_unit_jing_spearmen		true
unit_description_historical_texts_text_hv_unit_jing_sabre_cavalry		true
unit_description_historical_texts_text_hv_unit_bandit_axemen		true
unit_description_historical_texts_text_hv_unit_bandit_long_axemen		true
unit_description_historical_texts_text_hv_unit_bandit_long_spearmen		true
unit_description_historical_texts_text_hv_unit_bandit_archers		true
unit_description_historical_texts_text_hv_unit_warlord_elite_swordsmen		true
unit_description_historical_texts_text_hv_unit_warlord_elite_long_swordsmen		true
unit_description_historical_texts_text_hv_unit_warlord_elite_ji		true
unit_description_historical_texts_text_hv_unit_warlord_elite_lance_cavalry		true
unit_description_historical_texts_text_hv_unit_beihai_elite_spearmen		true
unit_description_historical_texts_text_hv_unit_beihai_elite_halberdiers		true
unit_description_historical_texts_text_hv_unit_beihai_elite_crossobwmen		true
unit_description_historical_texts_text_hv_unit_beihai_elite_repeating_crossobwmen		true
unit_description_historical_texts_text_hv_unit_xiliang_stalwarts_lance_cavalry		true
unit_description_historical_texts_text_hv_unit_xiliang_stalwarts_long_spearmen		true
unit_description_historical_texts_text_hv_unit_xiliang_rapid_bear_infantry		true
unit_description_historical_texts_text_hv_unit_xiliang_elite_halberdiers		true
unit_description_historical_texts_text_hv_unit_xiliang_elite_enforcers		true
unit_description_historical_texts_text_hv_unit_jing_elite_long_axemen		true
unit_description_historical_texts_text_hv_unit_jing_elite_spearmen		true
unit_description_historical_texts_text_hv_unit_jing_elite_heavy_bowmen		true
unit_description_historical_texts_text_hv_unit_double_blades		true
unit_description_historical_texts_text_hv_unit_iron_walls		true
unit_description_historical_texts_text_hv_unit_rapid_monkeys		true
unit_description_historical_texts_text_hv_unit_imperial_assault_cavalry		true
unit_description_historical_texts_text_hv_unit_imperial_swordsmen		true
unit_description_historical_texts_text_hv_unit_imperial_halberdier		true
unit_description_historical_texts_text_hv_unit_imperial_firelancer		true
unit_description_historical_texts_text_hv_unit_imperial_lance_cavalry		true
unit_description_historical_texts_text_hv_unit_yellow_dragons		true
unit_description_historical_texts_text_hv_unit_azure_dragons		true
unit_description_historical_texts_text_hv_unit_pearl_dragons		true
unit_description_historical_texts_text_hv_unit_onyx_dragons		true
unit_description_historical_texts_text_hv_unit_jade_dragons		true
unit_description_historical_texts_text_hv_unit_protectors_of_heaven		true
unit_description_historical_texts_text_hv_unit_defenders_of_earth		true
unit_description_historical_texts_text_hv_unit_qiang_axemen		true
unit_description_historical_texts_text_hv_unit_qiang_archers		true
unit_description_historical_texts_text_hv_unit_qiang_spearmen		true
unit_description_historical_texts_text_hv_unit_qiang_radier_cavalry		true
unit_description_historical_texts_text_hv_unit_qiang_mounted_warriors		true
unit_description_historical_texts_text_hv_unit_qiang_mounted_rangers		true
unit_description_historical_texts_text_hv_unit_wu_huan_cavalry		true
unit_description_historical_texts_text_hv_unit_barded_wu_huan_cavalry		true
unit_description_historical_texts_text_hv_unit_xiongnu_warriors		true
unit_description_historical_texts_text_hv_unit_xiongnu_cataphracts		true
unit_description_historical_texts_text_hv_unit_xiongnu_mounted_archers		true
unit_description_historical_texts_text_hv_unit_sogd_warriors		true
unit_description_historical_texts_text_hv_unit_xionite_cavalry		true
unit_description_historical_texts_text_hv_unit_shan_yue_warriors		true
unit_description_historical_texts_text_hv_unit_shan_yue_archers		true
unit_description_historical_texts_text_hv_unit_yue_remnants		true
unit_description_historical_texts_text_hv_unit_wulingman_long_axemen		true
unit_description_historical_texts_text_hv_unit_wulingman_archers		true
unit_description_historical_texts_text_hv_unit_ytr_trebuchet		true
unit_description_historical_texts_text_hv_unit_trebuchet_bastion		true
unit_description_historical_texts_text_hv_unit_trebuchet		true
unit_description_historical_texts_text_hv_unit_ytr_multiple_bolt_crossbow		true
unit_description_historical_texts_text_hv_unit_multiple_bolt_crossbow		true
unit_description_historical_texts_text_hv_unit_multiple_bolt_crossbow_bastion		true
unit_description_historical_texts_text_hv_unit_qingzhou_long_axemen		true
unit_description_historical_texts_text_hv_unit_qingzhou_infantry		true
unit_description_historical_texts_text_hv_unit_tiger_leopard_cavalry		true
unit_description_historical_texts_text_hv_unit_buqu_of_left		true
unit_description_historical_texts_text_hv_unit_mounted_scouts		true
unit_description_historical_texts_text_hv_unit_fellows_of_the_oath		true
unit_description_historical_texts_text_hv_unit_white_feathers		true
unit_description_historical_texts_text_hv_unit_jei_fan		true
unit_description_historical_texts_text_hv_unit_blue_turbans		true
unit_description_historical_texts_text_hv_unit_female_guards		true
unit_description_historical_texts_text_hv_unit_house_of_yuan_ji		true
unit_description_historical_texts_text_hv_unit_house_of_yuan_swordsmen		true
unit_description_historical_texts_text_hv_unit_porcupine_crossbowmen		true
unit_description_historical_texts_text_hv_unit_iron_zhong_royal_guards		true
unit_description_historical_texts_text_hv_unit_white_horse_fellows		true
unit_description_historical_texts_text_hv_unit_iron_fists_officers		true
unit_description_historical_texts_text_hv_unit_xiliang_elite_barded_cavalry		true
unit_description_historical_texts_text_hv_unit_xian_chen_ying		true
unit_description_historical_texts_text_hv_unit_beihai_guards		true
unit_description_historical_texts_text_hv_unit_beihai_mounted_crossbowmen		true
unit_description_historical_texts_text_hv_unit_xuzhou_archers		true
unit_description_historical_texts_text_hv_unit_xuzhou_guardsmen		true
unit_description_historical_texts_text_hv_unit_dan_yang_infantry		true
unit_description_historical_texts_text_hv_unit_goshawk_cavalry		true
unit_description_historical_texts_text_hv_unit_fire_bomber		true
unit_description_historical_texts_text_hv_unit_yuan_rong_crossbowmen		true
unit_description_historical_texts_text_hv_unit_southern_assault		true
unit_description_historical_texts_text_hv_unit_chen_peacekeepers		true
unit_description_historical_texts_text_hv_unit_chen_royal_horseguards		true
unit_description_historical_texts_text_hv_unit_taishan_archers_lime		true
unit_description_historical_texts_text_hv_unit_taishan_assault		true
unit_description_historical_texts_text_hv_unit_taishan_batters		true
unit_description_historical_texts_text_hv_unit_fists_of_bandit_queen		true
unit_description_historical_texts_text_hv_unit_black_mountain_bandits		true
unit_description_historical_texts_text_hv_unit_black_mountain_hunters		true
unit_description_historical_texts_text_hv_unit_black_mountain_cavalry		true
unit_description_historical_texts_text_hv_unit_white_tiger_warriors		true
unit_description_historical_texts_text_hv_unit_white_tiger_spearmen		true
unit_description_historical_texts_text_hv_unit_sabre_guardsmen		true
unit_description_historical_texts_text_hv_unit_archers_guardsmen		true
unit_description_historical_texts_text_hv_unit_ji_guardsmen		true
unit_description_historical_texts_text_hv_unit_mercenary_captain		true
unit_description_historical_texts_text_hv_unit_yuan_shao_captain		true
unit_description_historical_texts_text_hv_unit_han_settlement_captain		true
unit_description_historical_texts_text_hv_unit_ytr_settlement_captain		true
land_units_onscreen_name_hv_unit_bandit_imperial_bowmen	任侠射手	true
land_units_onscreen_name_hv_unit_bandit_imperial_juggernaut	任侠大刀手	true
land_units_onscreen_name_hv_unit_bandit_imperial_cavalry	任侠骑士	true
land_units_onscreen_name_hv_unit_jing_local_noble_family_infantry	地方豪强勇士	true
land_units_onscreen_name_hv_unit_jing_local_noble_family_archers	地方豪强弓手	true
land_units_onscreen_name_hv_unit_jing_local_noble_family_cavalry	地方豪强骑马勇士	true
unit_description_short_texts_text_hv_unit_bandit_imperial_bowmen	第四阶 - 禁军	true
unit_description_short_texts_text_hv_unit_bandit_imperial_juggernaut	第四阶 - 禁军	true
unit_description_short_texts_text_hv_unit_bandit_imperial_cavalry	第四阶 - 禁军	true
unit_description_short_texts_text_hv_unit_jing_local_noble_family_infantry	第二阶 - 地方材官	true
unit_description_short_texts_text_hv_unit_jing_local_noble_family_archers	第二阶 - 地方材官	true
unit_description_short_texts_text_hv_unit_jing_local_noble_family_cavalry	第二阶 - 地方材官	true
unit_description_historical_texts_text_hv_unit_bandit_imperial_bowmen		true
unit_description_historical_texts_text_hv_unit_bandit_imperial_juggernaut		true
unit_description_historical_texts_text_hv_unit_bandit_imperial_cavalry		true
unit_description_historical_texts_text_hv_unit_jing_local_noble_family_infantry		true
unit_description_historical_texts_text_hv_unit_jing_local_noble_family_archers		true
unit_description_historical_texts_text_hv_unit_jing_local_noble_family_cavalry		true
land_units_onscreen_name_hv_unit_nomad_gang	游牧马贼突击者	true
unit_description_short_texts_text_hv_unit_nomad_gang	第二阶 - 地方材官	true
unit_description_historical_texts_text_hv_unit_nomad_gang		true
land_units_onscreen_name_hv_unit_nomad_mounted_archers	游牧马贼马弓手	true
unit_description_short_texts_text_hv_unit_nomad_mounted_archers	第二阶 - 地方材官	true
unit_description_historical_texts_text_hv_unit_nomad_mounted_archers		true
land_units_onscreen_name_hv_unit_yue_freemen_sabre	越人解放刀兵	true
unit_description_short_texts_text_hv_unit_yue_freemen_sabre	第二阶 - 地方材官	true
unit_description_historical_texts_text_hv_unit_yue_freemen_sabre		true
land_units_onscreen_name_hv_unit_yue_freemen_hand_ji	越人解放手戟兵	true
unit_description_short_texts_text_hv_unit_yue_freemen_hand_ji	第二阶 - 地方材官	true
unit_description_historical_texts_text_hv_unit_yue_freemen_hand_ji		true
land_units_onscreen_name_hv_unit_strays_black_mountain	黑山流民	true
unit_description_short_texts_text_hv_unit_strays_black_mountain	第一阶 - 应征流民	true
unit_description_historical_texts_text_hv_unit_strays_black_mountain		true
land_units_onscreen_name_hv_unit_strays_taishan	泰山流民	true
unit_description_short_texts_text_hv_unit_strays_taishan	第一阶 - 应征流民	true
unit_description_historical_texts_text_hv_unit_strays_taishan		true
land_units_onscreen_name_hv_unit_strays_white_tiger	白虎流民	true
unit_description_short_texts_text_hv_unit_strays_white_tiger	第一阶 - 应征流民	true
unit_description_historical_texts_text_hv_unit_strays_white_tiger		true
land_units_onscreen_name_hv_unit_beihai_fire_archers	建安重门弓兵	true
unit_description_short_texts_text_hv_unit_beihai_fire_archers	第二阶 - 地方材官	true
unit_description_historical_texts_text_hv_unit_beihai_fire_archers		true
land_units_onscreen_name_hv_unit_defector_peoples_warband	变节人民军团	true
land_units_onscreen_name_hv_unit_defector_bringers_of_righteousness	变节布义军	true
land_units_onscreen_name_hv_unit_defector_venerable_wu	变节神巫	true
land_units_onscreen_name_hv_unit_defector_zealots_of_the_way	变节崇道狂士	true
land_units_onscreen_name_hv_unit_defector_poachers	变节偷猎者	true
land_units_onscreen_name_hv_unit_bandit_crossbowmen	盗匪弩兵	true
unit_description_short_texts_text_hv_unit_bandit_crossbowmen	第二阶 - 地方材官	true
unit_description_historical_texts_text_hv_unit_bandit_crossbowmen		true
land_units_onscreen_name_hv_unit_bandit_sabre_cavalry	盗匪突击骑兵	true
unit_description_short_texts_text_hv_unit_bandit_sabre_cavalry	第二阶 - 地方材官	true
unit_description_historical_texts_text_hv_unit_bandit_sabre_cavalry		true
land_units_onscreen_name_hv_unit_bandit_spearmen	盗匪矛兵	true
unit_description_short_texts_text_hv_unit_bandit_spearmen	第二阶 - 地方材官	true
unit_description_historical_texts_text_hv_unit_bandit_spearmen		true
land_units_onscreen_name_hv_unit_bandit_axe_guardsmen	盗匪近卫斧兵	true
unit_description_short_texts_text_hv_unit_bandit_axe_guardsmen	第二阶 - 地方材官	true
unit_description_historical_texts_text_hv_unit_bandit_axe_guardsmen		true
land_units_onscreen_name_hv_unit_bandit_bow_guardsmen	盗匪近卫弓兵	true
unit_description_short_texts_text_hv_unit_bandit_bow_guardsmen	第二阶 - 地方材官	true
unit_description_historical_texts_text_hv_unit_bandit_bow_guardsmen		true
land_units_onscreen_name_hv_unit_bandit_imperial_guardsmen	大义禁卫	true
unit_description_short_texts_text_hv_unit_bandit_imperial_guardsmen	第四阶 - 禁军	true
unit_description_historical_texts_text_hv_unit_bandit_imperial_guardsmen		true
land_units_onscreen_name_hv_unit_eagle_owl_rangers	鸱鸮射手	true
unit_description_short_texts_text_hv_unit_eagle_owl_rangers	第二阶 - 地方材官	true
unit_description_historical_texts_text_hv_unit_eagle_owl_rangers		true
land_units_onscreen_name_hv_unit_destroyer_of_traitors	平叛义军	true
unit_description_short_texts_text_hv_unit_destroyer_of_traitors	第二阶 - 地方材官	true
unit_description_historical_texts_text_hv_unit_destroyer_of_traitors		true
land_units_onscreen_name_hv_unit_spearmen_gang	矛兵团	true
unit_description_short_texts_text_hv_unit_spearmen_gang	第一阶 - 义勇民兵	true
unit_description_historical_texts_text_hv_unit_spearmen_gang		true
land_units_onscreen_name_hv_unit_long_axemen_gang	斧兵团	true
unit_description_short_texts_text_hv_unit_long_axemen_gang	第一阶 - 义勇民兵	true
unit_description_historical_texts_text_hv_unit_long_axemen_gang		true
land_units_onscreen_name_hv_unit_wandering_artisans	浪世匠人	true
unit_description_short_texts_text_hv_unit_wandering_artisans	第一阶 - 志愿乡勇	true
unit_description_historical_texts_text_hv_unit_wandering_artisans		true
