key	text	tooltip
#Loc;1;text/!@hv_TEXT_TECH.loc		
technologies_onscreen_name_3k_main_tech_wood_tier0_provincial_iron_tool_forges	{{tr:3k_main_text_replacement_tech_fire_tier1_military_markets_name_key}}	true
technologies_onscreen_name_3k_main_tech_wood_tier0_resettlement_incentives	{{tr:3k_main_text_replacement_tech_wood_tier0_resettlement_incentives_name_key}}	true
technologies_onscreen_name_3k_main_tech_wood_tier1_agricultural_tax_relief	{{tr:3k_main_text_replacement_tech_wood_tier1_agricultural_tax_relief_name_key}}	true
technologies_onscreen_name_3k_main_tech_wood_tier1_government_tool_distribution	{{tr:3k_main_text_replacement_tech_fire_tier1_garrison_conscripts_name_key}}	true
technologies_onscreen_name_3k_main_tech_wood_tier1_transverse_bulkheads	{{tr:3k_main_text_replacement_tech_fire_tier0_regional_commissioners_name_key}}	true
technologies_onscreen_name_3k_main_tech_wood_tier1_winnowing_machines	{{tr:3k_main_text_replacement_tech_water_tier0_foreign_envoys_name_key}}	true
technologies_onscreen_name_3k_main_tech_wood_tier2_disaster_relief_systems	{{tr:3k_main_text_replacement_tech_wood_tier2_government_controlled_granaries_name_key}}	true
technologies_onscreen_name_3k_main_tech_wood_tier2_government_controlled_granaries	{{tr:3k_main_text_replacement_tech_wood_tier2_permission_to_forage_name_key}}	true
technologies_onscreen_name_3k_main_tech_wood_tier2_irrigation_systems	{{tr:3k_main_text_replacement_tech_metal_tier1_pottery_bricks_name_key}}	true
technologies_onscreen_name_3k_main_tech_wood_tier2_junks	{{tr:3k_main_text_replacement_tech_wood_tier2_sharecropping_name_key}}	true
technologies_onscreen_name_3k_main_tech_wood_tier2_manual_of_farming_techniques	{{tr:3k_main_text_replacement_tech_wood_tier1_winnowing_machines_name_key}}	true
technologies_onscreen_name_3k_main_tech_wood_tier2_permission_to_forage	{{tr:3k_main_text_replacement_tech_water_tier0_private_tutors_name_key}}	true
technologies_onscreen_name_3k_main_tech_wood_tier2_sharecropping	地方军 1	true
technologies_onscreen_name_3k_main_tech_wood_tier3_agricultural_garrisons	地方军 2	true
technologies_onscreen_name_3k_main_tech_wood_tier3_facilitation_of_landlord_exploitation	{{tr:3k_main_text_replacement_tech_fire_tier2_convict_drafts_name_key}}	true
technologies_onscreen_name_3k_main_tech_wood_tier3_intensive_cultivation_techniques	{{tr:3k_main_text_replacement_tech_earth_tier1_civil_service_recommendations_name_key}}	true
technologies_short_description_3k_main_tech_wood_tier0_provincial_iron_tool_forges	{{tr:3k_main_text_replacement_tech_fire_tier1_military_markets_short_description_key}}	true
technologies_short_description_3k_main_tech_wood_tier0_resettlement_incentives	{{tr:3k_main_text_replacement_tech_wood_tier0_resettlement_incentives_short_description_key}}	true
technologies_short_description_3k_main_tech_wood_tier1_agricultural_tax_relief	{{tr:3k_main_text_replacement_tech_wood_tier1_agricultural_tax_relief_short_description_key}}	true
technologies_short_description_3k_main_tech_wood_tier1_government_tool_distribution	{{tr:3k_main_text_replacement_tech_fire_tier1_garrison_conscripts_short_description_key}}	true
technologies_short_description_3k_main_tech_wood_tier1_transverse_bulkheads	{{tr:3k_main_text_replacement_tech_fire_tier0_regional_commissioners_short_description_key}}	true
technologies_short_description_3k_main_tech_wood_tier1_winnowing_machines	{{tr:3k_main_text_replacement_tech_water_tier0_foreign_envoys_short_description_key}}	true
technologies_short_description_3k_main_tech_wood_tier2_disaster_relief_systems	{{tr:3k_main_text_replacement_tech_wood_tier2_government_controlled_granaries_short_description_key}}	true
technologies_short_description_3k_main_tech_wood_tier2_government_controlled_granaries	{{tr:3k_main_text_replacement_tech_wood_tier2_permission_to_forage_short_description_key}}	true
technologies_short_description_3k_main_tech_wood_tier2_irrigation_systems	{{tr:3k_main_text_replacement_tech_metal_tier1_pottery_bricks_short_description_key}}	true
technologies_short_description_3k_main_tech_wood_tier2_junks	{{tr:3k_main_text_replacement_tech_wood_tier2_sharecropping_short_description_key}}	true
technologies_short_description_3k_main_tech_wood_tier2_manual_of_farming_techniques	{{tr:3k_main_text_replacement_tech_wood_tier1_winnowing_machines_short_description_key}}	true
technologies_short_description_3k_main_tech_wood_tier2_permission_to_forage	{{tr:3k_main_text_replacement_tech_water_tier0_private_tutors_short_description_key}}	true
technologies_short_description_3k_main_tech_wood_tier2_sharecropping	重建军制以训练更专业兵士。	true
technologies_short_description_3k_main_tech_wood_tier3_agricultural_garrisons	重建军制以训练更专业兵士。	true
technologies_short_description_3k_main_tech_wood_tier3_facilitation_of_landlord_exploitation	{{tr:3k_main_text_replacement_tech_fire_tier2_convict_drafts_short_description_key}}	true
technologies_short_description_3k_main_tech_wood_tier3_intensive_cultivation_techniques	{{tr:3k_main_text_replacement_tech_earth_tier1_civil_service_recommendations_short_description_key}}	true
technologies_long_description_3k_main_tech_wood_tier0_provincial_iron_tool_forges	{{tr:3k_main_text_replacement_tech_fire_tier1_military_markets_long_description_key}}	true
technologies_long_description_3k_main_tech_wood_tier0_resettlement_incentives	{{tr:3k_main_text_replacement_tech_wood_tier0_resettlement_incentives_long_description_key}}	true
technologies_long_description_3k_main_tech_wood_tier1_agricultural_tax_relief	{{tr:3k_main_text_replacement_tech_wood_tier1_agricultural_tax_relief_long_description_key}}	true
technologies_long_description_3k_main_tech_wood_tier1_government_tool_distribution	{{tr:3k_main_text_replacement_tech_fire_tier1_garrison_conscripts_long_description_key}}	true
technologies_long_description_3k_main_tech_wood_tier1_transverse_bulkheads	{{tr:3k_main_text_replacement_tech_fire_tier0_regional_commissioners_long_description_key}}	true
technologies_long_description_3k_main_tech_wood_tier1_winnowing_machines	{{tr:3k_main_text_replacement_tech_water_tier0_foreign_envoys_long_description_key}}	true
technologies_long_description_3k_main_tech_wood_tier2_disaster_relief_systems	{{tr:3k_main_text_replacement_tech_wood_tier2_government_controlled_granaries_long_description_key}}	true
technologies_long_description_3k_main_tech_wood_tier2_government_controlled_granaries	{{tr:3k_main_text_replacement_tech_wood_tier2_permission_to_forage_long_description_key}}	true
technologies_long_description_3k_main_tech_wood_tier2_irrigation_systems	{{tr:3k_main_text_replacement_tech_metal_tier1_pottery_bricks_long_description_key}}	true
technologies_long_description_3k_main_tech_wood_tier2_junks	{{tr:3k_main_text_replacement_tech_wood_tier2_sharecropping_long_description_key}}	true
technologies_long_description_3k_main_tech_wood_tier2_manual_of_farming_techniques	{{tr:3k_main_text_replacement_tech_wood_tier1_winnowing_machines_long_description_key}}	true
technologies_long_description_3k_main_tech_wood_tier2_permission_to_forage	{{tr:3k_main_text_replacement_tech_water_tier0_private_tutors_long_description_key}}	true
technologies_long_description_3k_main_tech_wood_tier2_sharecropping	重建军制以训练更专业兵士。	true
technologies_long_description_3k_main_tech_wood_tier3_agricultural_garrisons	重建军制以训练更专业兵士。	true
technologies_long_description_3k_main_tech_wood_tier3_facilitation_of_landlord_exploitation	{{tr:3k_main_text_replacement_tech_fire_tier2_convict_drafts_long_description_key}}	true
technologies_long_description_3k_main_tech_wood_tier3_intensive_cultivation_techniques	{{tr:3k_main_text_replacement_tech_earth_tier1_civil_service_recommendations_long_description_key}}	true
technologies_onscreen_name_3k_main_tech_water_tier0_foreign_envoys	{{tr:3k_main_text_replacement_tech_metal_tier2_shaft_mining_name_key}}	true
technologies_onscreen_name_3k_main_tech_water_tier0_private_tutors	{{tr:3k_main_text_replacement_tech_fire_tier2_supply_canals_name_key}}	true
technologies_onscreen_name_3k_main_tech_water_tier1_annual_proficiency_reports	{{tr:3k_main_text_replacement_tech_wood_tier2_manual_of_farming_techniques_name_key}}	true
technologies_onscreen_name_3k_main_tech_water_tier1_diplomatic_missions	{{tr:3k_main_text_replacement_tech_water_tier1_diplomatic_missions_name_key}}	true
technologies_onscreen_name_3k_main_tech_water_tier1_masterful_disguise_techniques	{{tr:3k_main_text_replacement_tech_wood_tier1_transverse_bulkheads_name_key}}	true
technologies_onscreen_name_3k_main_tech_water_tier2_dedicated_spy_network	{{tr:3k_main_text_replacement_tech_wood_tier2_irrigation_systems_name_key}}	true
technologies_onscreen_name_3k_main_tech_water_tier2_handbook_of_excellence	{{tr:3k_main_text_replacement_tech_metal_tier1_government_enterprises_name_key}}	true
technologies_onscreen_name_3k_main_tech_water_tier2_inns	{{tr:3k_main_text_replacement_tech_earth_tier1_bureau_of_banditry_name_key}}	true
technologies_onscreen_name_3k_main_tech_water_tier2_market_administration	{{tr:3k_main_text_replacement_tech_fire_tier2_regional_levy_name_key}}	true
technologies_onscreen_name_3k_main_tech_water_tier2_sino-roman_embassy	{{tr:3k_main_text_replacement_tech_metal_tier0_currency_based_economy_name_key}}	true
technologies_onscreen_name_3k_main_tech_water_tier3_divine_manipultation_of_threads	{{tr:3k_main_text_replacement_tech_wood_tier3_intensive_cultivation_techniques_name_key}}	true
technologies_onscreen_name_3k_main_tech_water_tier3_hostels	{{tr:3k_main_text_replacement_tech_metal_tier2_corvee_labour_name_key}}	true
technologies_onscreen_name_3k_main_tech_water_tier3_silk_road_expeditions	{{tr:3k_main_text_replacement_tech_water_tier3_silk_road_expeditions_name_key}}	true
technologies_onscreen_name_3k_main_tech_water_tier3_trading	{{tr:3k_main_text_replacement_tech_water_tier2_market_administration_name_key}}	true
technologies_onscreen_name_3k_main_tech_water_tier3_treatise_on_human_beings	攻城器械	true
technologies_onscreen_name_3k_main_tech_water_tier3_way_of_great_peace	市场规范	true
technologies_short_description_3k_main_tech_water_tier0_foreign_envoys	{{tr:3k_main_text_replacement_tech_metal_tier2_shaft_mining_short_description_key}}	true
technologies_short_description_3k_main_tech_water_tier0_private_tutors	{{tr:3k_main_text_replacement_tech_fire_tier2_supply_canals_short_description_key}}	true
technologies_short_description_3k_main_tech_water_tier1_annual_proficiency_reports	{{tr:3k_main_text_replacement_tech_wood_tier2_manual_of_farming_techniques_short_description_key}}	true
technologies_short_description_3k_main_tech_water_tier1_diplomatic_missions	{{tr:3k_main_text_replacement_tech_water_tier1_diplomatic_missions_short_description_key}}	true
technologies_short_description_3k_main_tech_water_tier1_masterful_disguise_techniques	{{tr:3k_main_text_replacement_tech_wood_tier1_transverse_bulkheads_short_description_key}}	true
technologies_short_description_3k_main_tech_water_tier2_dedicated_spy_network	{{tr:3k_main_text_replacement_tech_wood_tier2_irrigation_systems_short_description_key}}	true
technologies_short_description_3k_main_tech_water_tier2_handbook_of_excellence	{{tr:3k_main_text_replacement_tech_metal_tier1_government_enterprises_short_description_key}}	true
technologies_short_description_3k_main_tech_water_tier2_inns	{{tr:3k_main_text_replacement_tech_earth_tier1_bureau_of_banditry_short_description_key}}	true
technologies_short_description_3k_main_tech_water_tier2_market_administration	{{tr:3k_main_text_replacement_tech_fire_tier2_regional_levy_short_description_key}}	true
technologies_short_description_3k_main_tech_water_tier2_sino-roman_embassy	{{tr:3k_main_text_replacement_tech_metal_tier0_currency_based_economy_short_description_key}}	true
technologies_short_description_3k_main_tech_water_tier3_divine_manipultation_of_threads	{{tr:3k_main_text_replacement_tech_wood_tier3_intensive_cultivation_techniques_short_description_key}}	true
technologies_short_description_3k_main_tech_water_tier3_hostels	{{tr:3k_main_text_replacement_tech_metal_tier2_corvee_labour_short_description_key}}	true
technologies_short_description_3k_main_tech_water_tier3_silk_road_expeditions	{{tr:3k_main_text_replacement_tech_water_tier3_silk_road_expeditions_short_description_key}}	true
technologies_short_description_3k_main_tech_water_tier3_trading	{{tr:3k_main_text_replacement_tech_water_tier2_market_administration_short_description_key}}	true
technologies_short_description_3k_main_tech_water_tier3_treatise_on_human_beings	培育制作攻城器械的工匠。	true
technologies_short_description_3k_main_tech_water_tier3_way_of_great_peace	于每个城市，皆有代理官员平准监管市场的物价。	true
technologies_long_description_3k_main_tech_water_tier0_foreign_envoys	{{tr:3k_main_text_replacement_tech_metal_tier2_shaft_mining_long_description_key}}	true
technologies_long_description_3k_main_tech_water_tier0_private_tutors	{{tr:3k_main_text_replacement_tech_fire_tier2_supply_canals_long_description_key}}	true
technologies_long_description_3k_main_tech_water_tier1_annual_proficiency_reports	{{tr:3k_main_text_replacement_tech_wood_tier2_manual_of_farming_techniques_long_description_key}}	true
technologies_long_description_3k_main_tech_water_tier1_diplomatic_missions	{{tr:3k_main_text_replacement_tech_water_tier1_diplomatic_missions_long_description_key}}	true
technologies_long_description_3k_main_tech_water_tier1_masterful_disguise_techniques	{{tr:3k_main_text_replacement_tech_wood_tier1_transverse_bulkheads_long_description_key}}	true
technologies_long_description_3k_main_tech_water_tier2_dedicated_spy_network	{{tr:3k_main_text_replacement_tech_wood_tier2_irrigation_systems_long_description_key}}	true
technologies_long_description_3k_main_tech_water_tier2_handbook_of_excellence	{{tr:3k_main_text_replacement_tech_metal_tier1_government_enterprises_long_description_key}}	true
technologies_long_description_3k_main_tech_water_tier2_inns	{{tr:3k_main_text_replacement_tech_earth_tier1_bureau_of_banditry_long_description_key}}	true
technologies_long_description_3k_main_tech_water_tier2_market_administration	{{tr:3k_main_text_replacement_tech_fire_tier2_regional_levy_long_description_key}}	true
technologies_long_description_3k_main_tech_water_tier2_sino-roman_embassy	{{tr:3k_main_text_replacement_tech_metal_tier0_currency_based_economy_long_description_key}}	true
technologies_long_description_3k_main_tech_water_tier3_divine_manipultation_of_threads	{{tr:3k_main_text_replacement_tech_wood_tier3_intensive_cultivation_techniques_long_description_key}}	true
technologies_long_description_3k_main_tech_water_tier3_hostels	{{tr:3k_main_text_replacement_tech_metal_tier2_corvee_labour_long_description_key}}	true
technologies_long_description_3k_main_tech_water_tier3_silk_road_expeditions	{{tr:3k_main_text_replacement_tech_water_tier3_silk_road_expeditions_long_description_key}}	true
technologies_long_description_3k_main_tech_water_tier3_trading	{{tr:3k_main_text_replacement_tech_water_tier2_market_administration_long_description_key}}	true
technologies_long_description_3k_main_tech_water_tier3_treatise_on_human_beings	培育制作攻城器械的工匠。	true
technologies_long_description_3k_main_tech_water_tier3_way_of_great_peace	不允许市场不受限的运作，以防天下被豪商所垄断掌控。	true
technologies_onscreen_name_3k_main_tech_fire_tier0_regional_commissioners	{{tr:3k_main_text_replacement_tech_water_tier2_inns_name_key}}	true
technologies_onscreen_name_3k_main_tech_fire_tier1_garrison_conscripts	{{tr:3k_main_text_replacement_tech_earth_tier0_register_of_land_and_population_name_key}}	true
technologies_onscreen_name_3k_main_tech_fire_tier1_military_markets	动员群众	true
technologies_onscreen_name_3k_main_tech_fire_tier1_provincial_military_forges	精锐部队 1	true
technologies_onscreen_name_3k_main_tech_fire_tier2_convict_drafts	精锐部队 2	true
technologies_onscreen_name_3k_main_tech_fire_tier2_regional_levy	{{tr:3k_main_text_replacement_tech_metal_tier1_slave_mobilisation_name_key}}	true
technologies_onscreen_name_3k_main_tech_fire_tier2_retainer_armies	{{tr:3k_main_text_replacement_tech_earth_tier2_application_of_five_punishments_name_key}}	true
technologies_onscreen_name_3k_main_tech_fire_tier2_shock_warfare	{{tr:3k_main_text_replacement_tech_wood_tier1_government_tool_distribution_name_key}}	true
technologies_onscreen_name_3k_main_tech_fire_tier2_supply_canals	{{tr:3k_main_text_replacement_tech_water_tier1_annual_proficiency_reports_name_key}}	true
technologies_onscreen_name_3k_main_tech_fire_tier3_barded_mounts	{{tr:3k_main_text_replacement_tech_earth_tier3_six_bureaus_of_bureaucracy_name_key}}	true
technologies_onscreen_name_3k_main_tech_fire_tier3_extension_of_conscription_period	政策整合	true
technologies_onscreen_name_3k_main_tech_fire_tier3_green_dragon_supply_ships	{{tr:3k_main_text_replacement_tech_earth_tier3_officer_relocation_name_key}}	true
technologies_onscreen_name_3k_main_tech_fire_tier3_hereditary_buqu	{{tr:3k_main_text_replacement_tech_earth_tier2_principles_of_wu_wei_name_key}}	true
technologies_onscreen_name_3k_main_tech_fire_tier3_hierarchical_enfeoffments	{{tr:3k_main_text_replacement_tech_fire_tier3_hierarchical_enfeoffments_name_key}}	true
technologies_onscreen_name_3k_main_tech_fire_tier3_strategic_fortresses	{{tr:3k_main_text_replacement_tech_water_tier2_dedicated_spy_network_name_key}}	true
technologies_onscreen_name_3k_main_tech_fire_tier3_swiftness_is_the_key_in_war	{{tr:3k_main_text_replacement_tech_water_tier3_divine_manipultation_of_threads_name_key}}	true
technologies_short_description_3k_main_tech_fire_tier0_regional_commissioners	{{tr:3k_main_text_replacement_tech_water_tier2_inns_short_description_key}}	true
technologies_short_description_3k_main_tech_fire_tier1_garrison_conscripts	{{tr:3k_main_text_replacement_tech_earth_tier0_register_of_land_and_population_short_description_key}}	true
technologies_short_description_3k_main_tech_fire_tier1_military_markets	当战事迫在眉睫，领主传唤其领民，领民们必须履行其义务。	true
technologies_short_description_3k_main_tech_fire_tier1_provincial_military_forges	重建军制以训练更专业兵士。	true
technologies_short_description_3k_main_tech_fire_tier2_convict_drafts	重建军制以训练更专业兵士。	true
technologies_short_description_3k_main_tech_fire_tier2_regional_levy	{{tr:3k_main_text_replacement_tech_metal_tier1_slave_mobilisation_short_description_key}}	true
technologies_short_description_3k_main_tech_fire_tier2_retainer_armies	{{tr:3k_main_text_replacement_tech_earth_tier2_application_of_five_punishments_short_description_key}}	true
technologies_short_description_3k_main_tech_fire_tier2_shock_warfare	{{tr:3k_main_text_replacement_tech_wood_tier1_government_tool_distribution_short_description_key}}	true
technologies_short_description_3k_main_tech_fire_tier2_supply_canals	{{tr:3k_main_text_replacement_tech_water_tier1_annual_proficiency_reports_short_description_key}}	true
technologies_short_description_3k_main_tech_fire_tier3_barded_mounts	{{tr:3k_main_text_replacement_tech_earth_tier3_six_bureaus_of_bureaucracy_short_description_key}}	true
technologies_short_description_3k_main_tech_fire_tier3_extension_of_conscription_period	若能了解彼此，可互交好友。	true
technologies_short_description_3k_main_tech_fire_tier3_green_dragon_supply_ships	{{tr:3k_main_text_replacement_tech_earth_tier3_officer_relocation_short_description_key}}	true
technologies_short_description_3k_main_tech_fire_tier3_hereditary_buqu	{{tr:3k_main_text_replacement_tech_earth_tier2_principles_of_wu_wei_short_description_key}}	true
technologies_short_description_3k_main_tech_fire_tier3_hierarchical_enfeoffments	{{tr:3k_main_text_replacement_tech_fire_tier3_hierarchical_enfeoffments_short_description_key}}	true
technologies_short_description_3k_main_tech_fire_tier3_strategic_fortresses	{{tr:3k_main_text_replacement_tech_water_tier2_dedicated_spy_network_short_description_key}}	true
technologies_short_description_3k_main_tech_fire_tier3_swiftness_is_the_key_in_war	{{tr:3k_main_text_replacement_tech_water_tier3_divine_manipultation_of_threads_short_description_key}}	true
technologies_long_description_3k_main_tech_fire_tier0_regional_commissioners	{{tr:3k_main_text_replacement_tech_water_tier2_inns_long_description_key}}	true
technologies_long_description_3k_main_tech_fire_tier1_garrison_conscripts	{{tr:3k_main_text_replacement_tech_earth_tier0_register_of_land_and_population_long_description_key}}	true
technologies_long_description_3k_main_tech_fire_tier1_military_markets	领主被赋予征兵的权利，当冲突吞噬领地之际，领主将征集所有身体健全的领民投入战斗。	true
technologies_long_description_3k_main_tech_fire_tier1_provincial_military_forges	重建军制以训练更专业兵士。	true
technologies_long_description_3k_main_tech_fire_tier2_convict_drafts	重建军制以训练更专业兵士。	true
technologies_long_description_3k_main_tech_fire_tier2_regional_levy	{{tr:3k_main_text_replacement_tech_metal_tier1_slave_mobilisation_long_description_key}}	true
technologies_long_description_3k_main_tech_fire_tier2_retainer_armies	{{tr:3k_main_text_replacement_tech_earth_tier2_application_of_five_punishments_long_description_key}}	true
technologies_long_description_3k_main_tech_fire_tier2_shock_warfare	{{tr:3k_main_text_replacement_tech_wood_tier1_government_tool_distribution_long_description_key}}	true
technologies_long_description_3k_main_tech_fire_tier2_supply_canals	{{tr:3k_main_text_replacement_tech_water_tier1_annual_proficiency_reports_long_description_key}}	true
technologies_long_description_3k_main_tech_fire_tier3_barded_mounts	{{tr:3k_main_text_replacement_tech_earth_tier3_six_bureaus_of_bureaucracy_long_description_key}}	true
technologies_long_description_3k_main_tech_fire_tier3_extension_of_conscription_period	有时候，吸引比对抗容易。	true
technologies_long_description_3k_main_tech_fire_tier3_green_dragon_supply_ships	{{tr:3k_main_text_replacement_tech_earth_tier3_officer_relocation_long_description_key}}	true
technologies_long_description_3k_main_tech_fire_tier3_hereditary_buqu	{{tr:3k_main_text_replacement_tech_earth_tier2_principles_of_wu_wei_long_description_key}}	true
technologies_long_description_3k_main_tech_fire_tier3_hierarchical_enfeoffments	{{tr:3k_main_text_replacement_tech_fire_tier3_hierarchical_enfeoffments_long_description_key}}	true
technologies_long_description_3k_main_tech_fire_tier3_strategic_fortresses	{{tr:3k_main_text_replacement_tech_water_tier2_dedicated_spy_network_long_description_key}}	true
technologies_long_description_3k_main_tech_fire_tier3_swiftness_is_the_key_in_war	{{tr:3k_main_text_replacement_tech_water_tier3_divine_manipultation_of_threads_long_description_key}}	true
technologies_onscreen_name_3k_main_tech_metal_tier0_currency_based_economy	{{tr:3k_main_text_replacement_tech_water_tier3_hostels_name_key}}	true
technologies_onscreen_name_3k_main_tech_metal_tier1_government_enterprises	{{tr:3k_main_text_replacement_tech_fire_tier3_strategic_fortresses_name_key}}	true
technologies_onscreen_name_3k_main_tech_metal_tier1_guide_to_estate_management	{{tr:3k_main_text_replacement_tech_earth_tier2_commissioners_of_passage_name_key}}	true
technologies_onscreen_name_3k_main_tech_metal_tier1_pottery_bricks	{{tr:3k_main_text_replacement_tech_metal_tier2_office_of_arts_and_crafts_name_key}}	true
technologies_onscreen_name_3k_main_tech_metal_tier1_slave_mobilisation	{{tr:3k_main_text_replacement_tech_wood_tier2_disaster_relief_systems_name_key}}	true
technologies_onscreen_name_3k_main_tech_metal_tier2_convict_workforce	{{tr:3k_main_text_replacement_tech_wood_tier3_agricultural_garrisons_name_key_key}}	true
technologies_onscreen_name_3k_main_tech_metal_tier2_corvee_labour	世袭军人	true
technologies_onscreen_name_3k_main_tech_metal_tier2_mercantile_regulation	{{tr:3k_main_text_replacement_tech_water_tier2_sino-roman_embassy_name_key}}	true
technologies_onscreen_name_3k_main_tech_metal_tier2_office_of_arts_and_crafts	{{tr:3k_main_text_replacement_tech_fire_tier1_provincial_military_forges_name_key}}	true
technologies_onscreen_name_3k_main_tech_metal_tier2_shaft_mining	{{tr:3k_main_text_replacement_tech_fire_tier3_hereditary_buqu_name_key}}	true
technologies_onscreen_name_3k_main_tech_metal_tier2_tax_commutation	{{tr:3k_main_text_replacement_tech_fire_tier3_swiftness_is_the_key_in_war_name_key}}	true
technologies_onscreen_name_3k_main_tech_metal_tier2_trade_associations	{{tr:3k_main_text_replacement_tech_fire_tier3_green_dragon_supply_ships_name_key}}	true
technologies_onscreen_name_3k_main_tech_metal_tier3_carburettor_chambers	{{tr:3k_main_text_replacement_tech_wood_tier3_facilitation_of_landlord_exploitation_name_key}}	true
technologies_onscreen_name_3k_main_tech_metal_tier3_horse_magnates	{{tr:3k_main_text_replacement_tech_metal_tier3_horse_magnates_name_key}}	true
technologies_onscreen_name_3k_main_tech_metal_tier3_rammed_earth	{{tr:3k_main_text_replacement_tech_earth_tier2_iron_and_salt_agencies_name_key}}	true
technologies_onscreen_name_3k_main_tech_metal_tier3_state_blast_furnaces	{{tr:3k_main_text_replacement_tech_earth_tier3_coin_minting_name_key}}	true
technologies_onscreen_name_3k_main_tech_metal_tier3_state_monopolies	{{tr:3k_main_text_replacement_tech_metal_tier3_state_monopolies_name_key}}	true
technologies_short_description_3k_main_tech_metal_tier0_currency_based_economy	{{tr:3k_main_text_replacement_tech_water_tier3_hostels_short_description_key}}	true
technologies_short_description_3k_main_tech_metal_tier1_government_enterprises	{{tr:3k_main_text_replacement_tech_fire_tier3_strategic_fortresses_short_description_key}}	true
technologies_short_description_3k_main_tech_metal_tier1_guide_to_estate_management	{{tr:3k_main_text_replacement_tech_earth_tier2_commissioners_of_passage_short_description_key}}	true
technologies_short_description_3k_main_tech_metal_tier1_pottery_bricks	{{tr:3k_main_text_replacement_tech_metal_tier2_office_of_arts_and_crafts_short_description_key}}	true
technologies_short_description_3k_main_tech_metal_tier1_slave_mobilisation	{{tr:3k_main_text_replacement_tech_wood_tier2_disaster_relief_systems_short_description_key}}	true
technologies_short_description_3k_main_tech_metal_tier2_convict_workforce	{{tr:3k_main_text_replacement_tech_wood_tier3_agricultural_garrisons_name_key_key}}	true
technologies_short_description_3k_main_tech_metal_tier2_corvee_labour	世袭军人，终身为军，无论有多大的可能，都可仰赖其确保忠诚及纪律。	true
technologies_short_description_3k_main_tech_metal_tier2_mercantile_regulation	{{tr:3k_main_text_replacement_tech_water_tier2_sino-roman_embassy_short_description_key}}	true
technologies_short_description_3k_main_tech_metal_tier2_office_of_arts_and_crafts	{{tr:3k_main_text_replacement_tech_fire_tier1_provincial_military_forges_short_description_key}}	true
technologies_short_description_3k_main_tech_metal_tier2_shaft_mining	{{tr:3k_main_text_replacement_tech_fire_tier3_hereditary_buqu_short_description_key}}	true
technologies_short_description_3k_main_tech_metal_tier2_tax_commutation	{{tr:3k_main_text_replacement_tech_fire_tier3_swiftness_is_the_key_in_war_short_description_key}}	true
technologies_short_description_3k_main_tech_metal_tier2_trade_associations	{{tr:3k_main_text_replacement_tech_fire_tier3_green_dragon_supply_ships_short_description_key}}	true
technologies_short_description_3k_main_tech_metal_tier3_carburettor_chambers	{{tr:3k_main_text_replacement_tech_wood_tier3_facilitation_of_landlord_exploitation_short_description_key}}	true
technologies_short_description_3k_main_tech_metal_tier3_horse_magnates	{{tr:3k_main_text_replacement_tech_metal_tier3_horse_magnates_short_description_key}}	true
technologies_short_description_3k_main_tech_metal_tier3_rammed_earth	{{tr:3k_main_text_replacement_tech_earth_tier2_iron_and_salt_agencies_short_description_key}}	true
technologies_short_description_3k_main_tech_metal_tier3_state_blast_furnaces	{{tr:3k_main_text_replacement_tech_earth_tier3_coin_minting_short_description_key}}	true
technologies_short_description_3k_main_tech_metal_tier3_state_monopolies	{{tr:3k_main_text_replacement_tech_metal_tier3_state_monopolies_short_description_key}}	true
technologies_long_description_3k_main_tech_metal_tier0_currency_based_economy	{{tr:3k_main_text_replacement_tech_water_tier3_hostels_long_description_key}}	true
technologies_long_description_3k_main_tech_metal_tier1_government_enterprises	{{tr:3k_main_text_replacement_tech_fire_tier3_strategic_fortresses_long_description_key}}	true
technologies_long_description_3k_main_tech_metal_tier1_guide_to_estate_management	{{tr:3k_main_text_replacement_tech_earth_tier2_commissioners_of_passage_long_description_key}}	true
technologies_long_description_3k_main_tech_metal_tier1_pottery_bricks	{{tr:3k_main_text_replacement_tech_metal_tier2_office_of_arts_and_crafts_long_description_key}}	true
technologies_long_description_3k_main_tech_metal_tier1_slave_mobilisation	{{tr:3k_main_text_replacement_tech_wood_tier2_disaster_relief_systems_long_description_key}}	true
technologies_long_description_3k_main_tech_metal_tier2_convict_workforce	{{tr:3k_main_text_replacement_tech_wood_tier3_agricultural_garrisons_name_key_key}}	true
technologies_long_description_3k_main_tech_metal_tier2_corvee_labour	多年前，曹操强化军制中的「部曲」为世袭军队，成为军人世家，从而确保其牺牲奉献。	true
technologies_long_description_3k_main_tech_metal_tier2_mercantile_regulation	{{tr:3k_main_text_replacement_tech_water_tier2_sino-roman_embassy_long_description_key}}	true
technologies_long_description_3k_main_tech_metal_tier2_office_of_arts_and_crafts	{{tr:3k_main_text_replacement_tech_fire_tier1_provincial_military_forges_long_description_key}}	true
technologies_long_description_3k_main_tech_metal_tier2_shaft_mining	{{tr:3k_main_text_replacement_tech_fire_tier3_hereditary_buqu_long_description_key}}	true
technologies_long_description_3k_main_tech_metal_tier2_tax_commutation	{{tr:3k_main_text_replacement_tech_fire_tier3_swiftness_is_the_key_in_war_long_description_key}}	true
technologies_long_description_3k_main_tech_metal_tier2_trade_associations	{{tr:3k_main_text_replacement_tech_fire_tier3_green_dragon_supply_ships_long_description_key}}	true
technologies_long_description_3k_main_tech_metal_tier3_carburettor_chambers	{{tr:3k_main_text_replacement_tech_wood_tier3_facilitation_of_landlord_exploitation_long_description_key}}	true
technologies_long_description_3k_main_tech_metal_tier3_horse_magnates	{{tr:3k_main_text_replacement_tech_metal_tier3_horse_magnates_long_description_key}}	true
technologies_long_description_3k_main_tech_metal_tier3_rammed_earth	{{tr:3k_main_text_replacement_tech_earth_tier2_iron_and_salt_agencies_long_description_key}}	true
technologies_long_description_3k_main_tech_metal_tier3_state_blast_furnaces	{{tr:3k_main_text_replacement_tech_earth_tier3_coin_minting_long_description_key}}	true
technologies_long_description_3k_main_tech_metal_tier3_state_monopolies	{{tr:3k_main_text_replacement_tech_metal_tier3_state_monopolies_long_description_key}}	true
technologies_onscreen_name_3k_main_tech_earth_tier0_eunuch_secretaries	{{tr:3k_main_text_replacement_tech_earth_tier0_eunuch_secretaries_name_key}}	true
technologies_onscreen_name_3k_main_tech_earth_tier0_mastery_of_ceremonies	麻沸散	true
technologies_onscreen_name_3k_main_tech_earth_tier0_register_of_land_and_population	{{tr:3k_main_text_replacement_tech_earth_tier2_metropolitan_superintendants_name_key}}	true
technologies_onscreen_name_3k_main_tech_earth_tier1_bureau_of_banditry	{{tr:3k_main_text_replacement_tech_water_tier3_treatise_on_human_beings_name_key}}	true
technologies_onscreen_name_3k_main_tech_earth_tier1_civil_service_recommendations	{{tr:3k_main_text_replacement_tech_earth_tier2_merchant_tax_exemptions_name_key}}	true
technologies_onscreen_name_3k_main_tech_earth_tier1_eunuch_regional_inspectors	{{tr:3k_main_text_replacement_tech_earth_tier1_eunuch_regional_inspectors_name_key}}	true
technologies_onscreen_name_3k_main_tech_earth_tier1_regular_palace_attendants	{{tr:3k_main_text_replacement_tech_earth_tier1_regular_palace_attendants_name_key}}	true
technologies_onscreen_name_3k_main_tech_earth_tier2_application_of_five_punishments	{{tr:3k_main_text_replacement_tech_water_tier2_handbook_of_excellence_name_key}}	true
technologies_onscreen_name_3k_main_tech_earth_tier2_commissioners_of_passage	和谐生活	true
technologies_onscreen_name_3k_main_tech_earth_tier2_iron_and_salt_agencies	{{tr:3k_main_text_replacement_tech_water_tier3_trading_name_key}}	true
technologies_onscreen_name_3k_main_tech_earth_tier2_merchant_tax_exemptions	制图改良	true
technologies_onscreen_name_3k_main_tech_earth_tier2_metropolitan_superintendants	宫廷禁卫	true
technologies_onscreen_name_3k_main_tech_earth_tier2_principles_of_wu_wei	禁军 1	true
technologies_onscreen_name_3k_main_tech_earth_tier2_selling_of_titles	{{tr:3k_main_text_replacement_tech_earth_tier2_selling_of_titles_name_key}}	true
technologies_onscreen_name_3k_main_tech_earth_tier3_coin_minting	朝廷命官	true
technologies_onscreen_name_3k_main_tech_earth_tier3_mandate_of_heaven	{{tr:3k_main_text_replacement_tech_earth_tier3_mandate_of_heaven_name_key}}	true
technologies_onscreen_name_3k_main_tech_earth_tier3_officer_relocation	{{tr:3k_main_text_replacement_tech_water_tier3_way_of_great_peace_name_key}}	true
technologies_onscreen_name_3k_main_tech_earth_tier3_six_bureaus_of_bureaucracy	忠诚奖赏	true
technologies_short_description_3k_main_tech_earth_tier0_eunuch_secretaries	{{tr:3k_main_text_replacement_tech_earth_tier0_eunuch_secretaries_short_description_key}}	true
technologies_short_description_3k_main_tech_earth_tier0_mastery_of_ceremonies	我将使用麻沸散麻醉你，然后打开你的头骨。	true
technologies_short_description_3k_main_tech_earth_tier0_register_of_land_and_population	{{tr:3k_main_text_replacement_tech_earth_tier2_metropolitan_superintendants_short_description_key}}	true
technologies_short_description_3k_main_tech_earth_tier1_bureau_of_banditry	{{tr:3k_main_text_replacement_tech_water_tier3_treatise_on_human_beings_short_description_key}}	true
technologies_short_description_3k_main_tech_earth_tier1_civil_service_recommendations	{{tr:3k_main_text_replacement_tech_earth_tier2_merchant_tax_exemptions_short_description_key}}	true
technologies_short_description_3k_main_tech_earth_tier1_eunuch_regional_inspectors	{{tr:3k_main_text_replacement_tech_earth_tier1_eunuch_regional_inspectors_short_description_key}}	true
technologies_short_description_3k_main_tech_earth_tier1_regular_palace_attendants	{{tr:3k_main_text_replacement_tech_earth_tier1_regular_palace_attendants_short_description_key}}	true
technologies_short_description_3k_main_tech_earth_tier2_application_of_five_punishments	{{tr:3k_main_text_replacement_tech_water_tier2_handbook_of_excellence_short_description_key}}	true
technologies_short_description_3k_main_tech_earth_tier2_commissioners_of_passage	专注团结，了解自身与周遭，那就是生活和谐。	true
technologies_short_description_3k_main_tech_earth_tier2_iron_and_salt_agencies	{{tr:3k_main_text_replacement_tech_water_tier3_trading_short_description_key}}	true
technologies_short_description_3k_main_tech_earth_tier2_merchant_tax_exemptions	知己知彼，百战不殆。	true
technologies_short_description_3k_main_tech_earth_tier2_metropolitan_superintendants	即使是最有能力的细作，也只能独力发展至如此。	true
technologies_short_description_3k_main_tech_earth_tier2_principles_of_wu_wei	重建军制以训练更专业兵士。	true
technologies_short_description_3k_main_tech_earth_tier2_selling_of_titles	{{tr:3k_main_text_replacement_tech_earth_tier2_selling_of_titles_short_description_key}}	true
technologies_short_description_3k_main_tech_earth_tier3_coin_minting	为了使朝廷能有效运作，必须给予各级官员充分授权。	true
technologies_short_description_3k_main_tech_earth_tier3_mandate_of_heaven	{{tr:3k_main_text_replacement_tech_earth_tier3_mandate_of_heaven_short_description_key}}	true
technologies_short_description_3k_main_tech_earth_tier3_officer_relocation	{{tr:3k_main_text_replacement_tech_water_tier3_way_of_great_peace_short_description_key}}	true
technologies_short_description_3k_main_tech_earth_tier3_six_bureaus_of_bureaucracy	朝廷以礼品表彰忠诚的将士，以示赞许。	true
technologies_long_description_3k_main_tech_earth_tier0_eunuch_secretaries	{{tr:3k_main_text_replacement_tech_earth_tier0_eunuch_secretaries_long_description_key}}	true
technologies_long_description_3k_main_tech_earth_tier0_mastery_of_ceremonies	著名的华陀发明了无数的膏药和方法（例如针灸）来帮助普通人和战士自伤疾中恢复。	true
technologies_long_description_3k_main_tech_earth_tier0_register_of_land_and_population	{{tr:3k_main_text_replacement_tech_earth_tier2_metropolitan_superintendants_long_description_key}}	true
technologies_long_description_3k_main_tech_earth_tier1_bureau_of_banditry	{{tr:3k_main_text_replacement_tech_water_tier3_treatise_on_human_beings_long_description_key}}	true
technologies_long_description_3k_main_tech_earth_tier1_civil_service_recommendations	{{tr:3k_main_text_replacement_tech_earth_tier2_merchant_tax_exemptions_long_description_key}}	true
technologies_long_description_3k_main_tech_earth_tier1_eunuch_regional_inspectors	{{tr:3k_main_text_replacement_tech_earth_tier1_eunuch_regional_inspectors_long_description_key}}	true
technologies_long_description_3k_main_tech_earth_tier1_regular_palace_attendants	{{tr:3k_main_text_replacement_tech_earth_tier1_regular_palace_attendants_long_description_key}}	true
technologies_long_description_3k_main_tech_earth_tier2_application_of_five_punishments	{{tr:3k_main_text_replacement_tech_water_tier2_handbook_of_excellence_long_description_key}}	true
technologies_long_description_3k_main_tech_earth_tier2_commissioners_of_passage	社会进步和无摩擦的共存发展有种紧密的连结，使我们更接近精神上的完美。	true
technologies_long_description_3k_main_tech_earth_tier2_iron_and_salt_agencies	{{tr:3k_main_text_replacement_tech_water_tier3_trading_long_description_key}}	true
technologies_long_description_3k_main_tech_earth_tier2_merchant_tax_exemptions	知道于何处阻击渡河或何处设伏，将导致最终胜利。	true
technologies_long_description_3k_main_tech_earth_tier2_metropolitan_superintendants	当面对如坚不可摧的力量，可能需要更昂贵的手段以确保成功突破。是说，代价需以血来定量......	true
technologies_long_description_3k_main_tech_earth_tier2_principles_of_wu_wei	重建军制以训练更专业兵士。	true
technologies_long_description_3k_main_tech_earth_tier2_selling_of_titles	{{tr:3k_main_text_replacement_tech_earth_tier2_selling_of_titles_long_description_key}}	true
technologies_long_description_3k_main_tech_earth_tier3_coin_minting	自有良好家世背景的人中举荐合适的行政官员。	true
technologies_long_description_3k_main_tech_earth_tier3_mandate_of_heaven	{{tr:3k_main_text_replacement_tech_earth_tier3_mandate_of_heaven_long_description_key}}	true
technologies_long_description_3k_main_tech_earth_tier3_officer_relocation	{{tr:3k_main_text_replacement_tech_water_tier3_way_of_great_peace_long_description_key}}	true
technologies_long_description_3k_main_tech_earth_tier3_six_bureaus_of_bureaucracy	皇帝长期以官衔和土地奖赏有功之士，暨是感谢其功抑是回报重任。	true
effects_description_hv_tech_turn_tier_0	下一次改革需 [[b]]%n[[/b]] 回合	true
effects_description_hv_tech_turn_tier_1	下一次改革需 [[b]]%n[[/b]] 回合	true
effects_description_hv_tech_turn_tier_2	下一次改革需 [[b]]%n[[/b]] 回合	true
effects_description_hv_tech_turn_tier_3	下一次改革需 [[b]]%n[[/b]] 回合	true
effects_description_hv_tech_effect_t2_recruitment_cost	正规军和盗匪部队的招募位费用 [[b]]%+n%[[/b]]	true
effects_description_hv_tech_effect_t2_melee_attack_stat	正规军和盗匪部队近战命中率 [[b]]%+n[[/b]]	true
effects_description_hv_tech_effect_t2_melee_defence_stat	正规军和盗匪部队近战回避 [[b]]%+n[[/b]]	true
effects_description_hv_tech_effect_t2_move_speed	正规军和盗匪部队的战场移动速度 [[b]]%+n%[[/b]]	true
effects_description_hv_tech_effect_t2_replenishment	正规军和盗匪部队的补员速率 [[b]]%+n%[[/b]]	true
effects_description_hv_tech_effect_t2_rank_new_recruits	正规军和盗匪部队的起始等级 [[b]]%+n[[/b]]	true
effects_description_hv_tech_effect_cavalry_mass_mod	骑兵部队质量 [[b]]%+n%[[/b]]	true
effects_description_hv_tech_effect_cavalry_missile_resist	骑兵部队远程抗性 [[b]]%+n%[[/b]]	true
effects_description_hv_tech_effect_t3_move_speed	精锐部队的战场移动速度[[b]]%+n%[[/b]]	true
effects_description_hv_tech_effect_t3_replenishment	精锐部队补员速率 [[b]]%+n%[[/b]]	true
effects_description_hv_tech_effect_t3_recruitment_cost	招募精锐部队费用 [[b]]%+n%[[/b]]	true
effects_description_hv_tech_effect_t3_rank_new_recruits	精锐部队起始等级 [[b]]%+n[[/b]]	true
effects_description_hv_tech_effect_t1_rank_new_recruits	农民兵、民兵和流民部队的起始等级 [[b]]%+n[[/b]]	true
effects_description_hv_tech_effect_t1_morale_stat	农民兵、民兵和流民部队的士气 [[b]]%+n[[/b]]	true
effects_description_hv_tech_effect_t2_morale_stat	正规军和盗匪部队的士气 [[b]]%+n[[/b]]	true
effects_description_hv_tech_effect_t1_replenishment	农民兵、民兵和流民部队的补员速率 [[b]]%+n%[[/b]]	true
effects_description_hv_tech_effect_t1_melee_attack_stat	农民兵、民兵和流民部队的近战命中率 [[b]]%+n[[/b]]	true
effects_description_hv_tech_effect_t1_melee_defence_stat	农民兵、民兵和流民部队的近战回避 [[b]]%+n[[/b]]	true
effects_description_3k_main_effect_force_army_campaign_recruitment_cost_weapon	全单位招募费用 [[b]]%+n%[[/b]]	true
effects_description_hv_tech_effect_hero_replenishment	英雄部队补员[[b]]%+n%[[/b]]	true
effects_description_hv_tech_effect_province_building_construction_cost_mod_immigrants	异民族建物建筑成本[[b]]%+n%[[/b]]	true
effects_description_hv_tech_effect_dummy_immigrants_influence	降低异民族影响力。	true
effects_description_hv_tech_effect_t4_replenishment	禁军部队部队补员[[b]]%+n%[[/b]]	true
effects_description_hv_tech_effect_building_conversion_cost	建筑成本[[b]]%+n%[[/b]]	true
technology_node_sets_localised_name_hv_tech_earth_peasant	农业	true
technology_node_sets_localised_name_hv_tech_earth_merchant	商贾	true
technology_node_sets_localised_name_hv_tech_earth_artisan	匠师	true
technology_node_sets_localised_name_hv_tech_earth_strategy	军师	true
technology_node_sets_localised_name_hv_tech_earth_philosophy	哲学	true
technology_node_sets_localised_name_hv_tech_earth_administration	官府	true
technology_node_sets_localised_name_hv_tech_earth_army	军队	true
technology_node_sets_localised_name_hv_tech_earth_general	将领	true
technology_node_sets_localised_name_hv_tech_earth_diplomacy	外交	true
technology_node_sets_localised_name_hv_tech_earth_trade	贸易	true
technology_node_sets_localised_name_hv_tech_earth_spy	细作	true
technology_node_sets_localised_name_hv_tech_fire_peasant	农业	true
technology_node_sets_localised_name_hv_tech_fire_merchant	商贾	true
technology_node_sets_localised_name_hv_tech_fire_artisan	匠师	true
technology_node_sets_localised_name_hv_tech_fire_strategy	军师	true
technology_node_sets_localised_name_hv_tech_fire_philosophy	哲学	true
technology_node_sets_localised_name_hv_tech_fire_administration	官府	true
technology_node_sets_localised_name_hv_tech_fire_army	军队	true
technology_node_sets_localised_name_hv_tech_fire_general	将领	true
technology_node_sets_localised_name_hv_tech_fire_diplomacy	外交	true
technology_node_sets_localised_name_hv_tech_fire_trade	贸易	true
technology_node_sets_localised_name_hv_tech_fire_spy	细作	true
technology_node_sets_localised_name_hv_tech_metal_peasant	农业	true
technology_node_sets_localised_name_hv_tech_metal_merchant	商贾	true
technology_node_sets_localised_name_hv_tech_metal_artisan	匠师	true
technology_node_sets_localised_name_hv_tech_metal_strategy	军师	true
technology_node_sets_localised_name_hv_tech_metal_philosophy	哲学	true
technology_node_sets_localised_name_hv_tech_metal_administration	官府	true
technology_node_sets_localised_name_hv_tech_metal_army	军队	true
technology_node_sets_localised_name_hv_tech_metal_general	将领	true
technology_node_sets_localised_name_hv_tech_metal_diplomacy	外交	true
technology_node_sets_localised_name_hv_tech_metal_trade	贸易	true
technology_node_sets_localised_name_hv_tech_metal_spy	细作	true
technology_node_sets_localised_name_hv_tech_water_peasant	农业	true
technology_node_sets_localised_name_hv_tech_water_merchant	商贾	true
technology_node_sets_localised_name_hv_tech_water_artisan	匠师	true
technology_node_sets_localised_name_hv_tech_water_strategy	军师	true
technology_node_sets_localised_name_hv_tech_water_philosophy	哲学	true
technology_node_sets_localised_name_hv_tech_water_administration	官府	true
technology_node_sets_localised_name_hv_tech_water_army	军队	true
technology_node_sets_localised_name_hv_tech_water_general	将领	true
technology_node_sets_localised_name_hv_tech_water_diplomacy	外交	true
technology_node_sets_localised_name_hv_tech_water_trade	贸易	true
technology_node_sets_localised_name_hv_tech_water_spy	细作	true
technology_node_sets_localised_name_hv_tech_wood_peasant	农业	true
technology_node_sets_localised_name_hv_tech_wood_merchant	商贾	true
technology_node_sets_localised_name_hv_tech_wood_artisan	匠师	true
technology_node_sets_localised_name_hv_tech_wood_strategy	军师	true
technology_node_sets_localised_name_hv_tech_wood_philosophy	哲学	true
technology_node_sets_localised_name_hv_tech_wood_administration	官府	true
technology_node_sets_localised_name_hv_tech_wood_army	军队	true
technology_node_sets_localised_name_hv_tech_wood_general	将领	true
technology_node_sets_localised_name_hv_tech_wood_diplomacy	外交	true
technology_node_sets_localised_name_hv_tech_wood_trade	贸易	true
technology_node_sets_localised_name_hv_tech_wood_spy	细作	true
effects_description_hv_tech_effect_yue_armour	越族部队护甲[[b]]%+n%[[/b]]	true
effects_description_hv_tech_effect_yue_recruitment_cost	越族部队的招募位费用 [[b]]%+n%[[/b]]	true
effects_description_hv_tech_effect_yue_upkeep	越族部队维持费[[b]]%+n%[[/b]]	true
effects_description_hv_tech_effect_yue_morale	越族部队的士气[[b]]%+n%[[/b]]	true
effects_description_hv_tech_effect_yue_charge_bonus	越族部队冲锋加成 [[b]]%+n%[[/b]]	true
effects_description_hv_tech_effect_yue_replenishment	越族部队补员[[b]]%+n%[[/b]]	true
effects_description_hv_tech_effect_nomad_upkeep	游牧部队维持费[[b]]%+n%[[/b]]	true
effects_description_hv_tech_effect_nomad_morale	游牧部队的士气[[b]]%+n%[[/b]]	true
effects_description_hv_tech_effect_nomad_replenishment	游牧部队补员[[b]]%+n%[[/b]]	true
effects_description_hv_tech_effect_nomad_recruitment_cost	游牧部队的招募费用 [[b]]%+n%[[/b]]	true
effects_description_hv_tech_effect_unit_cap_bandit_imperial_bowmen_info	[[i]]可招募{{tr:hv_tr_hv_unit_bandit_imperial_bowmen}}: %+n，当您的达到皇帝的派系等级时[[/i]]	true
effects_description_hv_tech_effect_unit_cap_bandit_imperial_juggernaut_info	[[i]]可招募{{tr:hv_tr_hv_unit_bandit_imperial_juggernaut}}: %+n，当您的达到皇帝的派系等级时[[/i]]	true
effects_description_hv_tech_effect_unit_cap_bandit_imperial_cavalry_info	[[i]]可招募{{tr:hv_tr_hv_unit_bandit_imperial_cavalry}}: %+n，当您的达到皇帝的派系等级时[[/i]]	true
effects_description_hv_tech_effect_unit_upkeep_mod_bandit_archers	盗匪弓兵维持费[[b]]%+n%[[/b]]	true
effects_description_hv_tech_effect_unit_upkeep_mod_bandit_axemen	盜匪斧兵维持费[[b]]%+n%[[/b]]	true
effects_description_hv_tech_effect_unit_upkeep_mod_bandit_cavalry	盗匪突击骑兵维持费[[b]]%+n%[[/b]]	true
effects_description_hv_tech_effect_unit_upkeep_mod_bandit_crossbowmen	盗匪弩兵维持费[[b]]%+n%[[/b]]	true
effects_description_hv_tech_effect_unit_upkeep_mod_bandit_cunning_monkeys	狡猿猎手维持费[[b]]%+n%[[/b]]	true
effects_description_hv_tech_effect_unit_upkeep_mod_bandit_double_blades	双刃力士维持费[[b]]%+n%[[/b]]	true
effects_description_hv_tech_effect_unit_upkeep_mod_bandit_iron_walls	铁壁军维持费[[b]]%+n%[[/b]]	true
effects_description_hv_tech_effect_unit_upkeep_mod_bandit_long_axemen	盗匪长斧兵维持费[[b]]%+n%[[/b]]	true
effects_description_hv_tech_effect_unit_upkeep_mod_bandit_long_spearmen	盗匪长枪兵维持费[[b]]%+n%[[/b]]	true
effects_description_hv_tech_effect_unit_upkeep_mod_bandit_spearmen	盗匪矛兵维持费[[b]]%+n%[[/b]]	true
effects_description_hv_tech_effect_unit_upkeep_mod_bandit_white_waves	白波旧部维持费[[b]]%+n%[[/b]]	true
effects_description_hv_tech_effect_unit_upkeep_mod_bandit_white_waves_cavalry	白波骑士维持费[[b]]%+n%[[/b]]	true
effects_description_hv_tech_effect_unit_upkeep_mod_defector_bringers_of_righteousness	布义军维持费[[b]]%+n%[[/b]]	true
effects_description_hv_tech_effect_unit_upkeep_mod_defector_peoples_warband	人民军团维持费[[b]]%+n%[[/b]]	true
effects_description_hv_tech_effect_unit_upkeep_mod_defector_poachers	偷猎者维持费[[b]]%+n%[[/b]]	true
effects_description_hv_tech_effect_unit_upkeep_mod_defector_venerable_wu	神巫维持费[[b]]%+n%[[/b]]	true
effects_description_hv_tech_effect_unit_upkeep_mod_defector_zealots_of_the_way	崇道狂士维持费[[b]]%+n%[[/b]]	true
effects_description_hv_tech_effect_unit_upkeep_mod_guanzhong_elite_halberdiers	关中精锐重戟卫士维持费[[b]]%+n%[[/b]]	true
effects_description_hv_tech_effect_unit_upkeep_mod_guanzhong_elite_maces	关中精锐铁锤战士维持费[[b]]%+n%[[/b]]	true
effects_description_hv_tech_effect_unit_upkeep_mod_multiple_crossbow	连发巨弩部队维持费[[b]]%+n%[[/b]]	true
effects_description_hv_tech_effect_unit_upkeep_mod_nomad_gang	游牧马贼突击者维持费[[b]]%+n%[[/b]]	true
effects_description_hv_tech_effect_unit_upkeep_mod_nomad_gang_mounted_archers	游牧马贼马弓手维持费[[b]]%+n%[[/b]]	true
effects_description_hv_tech_effect_unit_upkeep_mod_province_elite_crossbowmen	郡国精锐弩兵维持费[[b]]%+n%[[/b]]	true
effects_description_hv_tech_effect_unit_upkeep_mod_province_elite_repeating_crossbowmen	郡国精锐连弩兵维持费[[b]]%+n%[[/b]]	true
effects_description_hv_tech_effect_unit_upkeep_mod_province_elite_spearmen	郡国精锐枪卫维持费[[b]]%+n%[[/b]]	true
effects_description_hv_tech_effect_unit_upkeep_mod_trebuchet	霹雳车部队维持费[[b]]%+n%[[/b]]	true
effects_description_hv_tech_effect_unit_upkeep_mod_warlord_elite_cavalry	军阀精锐重装铁骑维持费[[b]]%+n%[[/b]]	true
effects_description_hv_tech_effect_unit_upkeep_mod_warlord_elite_long_sword	军阀精锐剑卫维持费[[b]]%+n%[[/b]]	true
effects_description_hv_tech_effect_unit_upkeep_mod_yue_freemen_hand_ji	越人解放手戟兵维持费[[b]]%+n%[[/b]]	true
effects_description_hv_tech_effect_unit_upkeep_mod_yue_freemen_sabre	越人解放刀兵维持费[[b]]%+n%[[/b]]	true
effects_description_hv_tech_effect_unit_recruitment_cost_mod_bandit_archers	盗匪弓兵招募费用[[b]]%+n%[[/b]]	true
effects_description_hv_tech_effect_unit_recruitment_cost_mod_bandit_axemen	盜匪斧兵招募费用[[b]]%+n%[[/b]]	true
effects_description_hv_tech_effect_unit_recruitment_cost_mod_bandit_cavalry	盗匪突击骑兵招募费用[[b]]%+n%[[/b]]	true
effects_description_hv_tech_effect_unit_recruitment_cost_mod_bandit_crossbowmen	盗匪弩兵招募费用[[b]]%+n%[[/b]]	true
effects_description_hv_tech_effect_unit_recruitment_cost_mod_bandit_cunning_monkeys	狡猿猎手招募费用[[b]]%+n%[[/b]]	true
effects_description_hv_tech_effect_unit_recruitment_cost_mod_bandit_double_blades	双刃力士招募费用[[b]]%+n%[[/b]]	true
effects_description_hv_tech_effect_unit_recruitment_cost_mod_bandit_iron_walls	铁壁军招募费用[[b]]%+n%[[/b]]	true
effects_description_hv_tech_effect_unit_recruitment_cost_mod_bandit_long_axemen	盗匪长斧兵招募费用[[b]]%+n%[[/b]]	true
effects_description_hv_tech_effect_unit_recruitment_cost_mod_bandit_long_spearmen	盗匪长枪兵招募费用[[b]]%+n%[[/b]]	true
effects_description_hv_tech_effect_unit_recruitment_cost_mod_bandit_spearmen	盗匪矛兵招募费用[[b]]%+n%[[/b]]	true
effects_description_hv_tech_effect_unit_recruitment_cost_mod_bandit_white_waves	白波旧部招募费用[[b]]%+n%[[/b]]	true
effects_description_hv_tech_effect_unit_recruitment_cost_mod_bandit_white_waves_cavalry	白波骑士招募费用[[b]]%+n%[[/b]]	true
effects_description_hv_tech_effect_unit_recruitment_cost_mod_defector_bringers_of_righteousness	布义军招募费用[[b]]%+n%[[/b]]	true
effects_description_hv_tech_effect_unit_recruitment_cost_mod_defector_peoples_warband	人民军团招募费用[[b]]%+n%[[/b]]	true
effects_description_hv_tech_effect_unit_recruitment_cost_mod_defector_poachers	偷猎者招募费用[[b]]%+n%[[/b]]	true
effects_description_hv_tech_effect_unit_recruitment_cost_mod_defector_venerable_wu	神巫招募费用[[b]]%+n%[[/b]]	true
effects_description_hv_tech_effect_unit_recruitment_cost_mod_defector_zealots_of_the_way	崇道狂士招募费用[[b]]%+n%[[/b]]	true
effects_description_hv_tech_effect_unit_recruitment_cost_mod_guanzhong_elite_halberdiers	关中精锐重戟卫士招募费用[[b]]%+n%[[/b]]	true
effects_description_hv_tech_effect_unit_recruitment_cost_mod_guanzhong_elite_maces	关中精锐铁锤战士招募费用[[b]]%+n%[[/b]]	true
effects_description_hv_tech_effect_unit_recruitment_cost_mod_multiple_crossbow	连发巨弩部队招募费用[[b]]%+n%[[/b]]	true
effects_description_hv_tech_effect_unit_recruitment_cost_mod_nomad_gang	游牧马贼突击者招募费用[[b]]%+n%[[/b]]	true
effects_description_hv_tech_effect_unit_recruitment_cost_mod_nomad_gang_mounted_archers	游牧马贼马弓手招募费用[[b]]%+n%[[/b]]	true
effects_description_hv_tech_effect_unit_recruitment_cost_mod_province_elite_crossbowmen	郡国精锐弩兵招募费用[[b]]%+n%[[/b]]	true
effects_description_hv_tech_effect_unit_recruitment_cost_mod_province_elite_repeating_crossbowmen	郡国精锐连弩兵招募费用[[b]]%+n%[[/b]]	true
effects_description_hv_tech_effect_unit_recruitment_cost_mod_province_elite_spearmen	郡国精锐枪卫招募费用[[b]]%+n%[[/b]]	true
effects_description_hv_tech_effect_unit_recruitment_cost_mod_trebuchet	霹雳车部队招募费用[[b]]%+n%[[/b]]	true
effects_description_hv_tech_effect_unit_recruitment_cost_mod_warlord_elite_cavalry	军阀精锐重装铁骑招募费用[[b]]%+n%[[/b]]	true
effects_description_hv_tech_effect_unit_recruitment_cost_mod_warlord_elite_long_sword	军阀精锐剑卫招募费用[[b]]%+n%[[/b]]	true
effects_description_hv_tech_effect_unit_recruitment_cost_mod_yue_freemen_hand_ji	越人解放手戟兵招募费用[[b]]%+n%[[/b]]	true
effects_description_hv_tech_effect_unit_recruitment_cost_mod_yue_freemen_sabre	越人解放刀兵招募费用[[b]]%+n%[[/b]]	true
technology_node_sets_localised_name_hv_tech_earth_peasant_dlc05	农业	true
technology_node_sets_localised_name_hv_tech_earth_merchant_dlc05	商贾	true
technology_node_sets_localised_name_hv_tech_earth_artisan_dlc05	匠师	true
technology_node_sets_localised_name_hv_tech_earth_strategy_dlc05	军师	true
technology_node_sets_localised_name_hv_tech_earth_philosophy_dlc05	哲学	true
technology_node_sets_localised_name_hv_tech_earth_administration_dlc05	官府	true
technology_node_sets_localised_name_hv_tech_earth_army_dlc05	军队	true
technology_node_sets_localised_name_hv_tech_earth_general_dlc05	将领	true
technology_node_sets_localised_name_hv_tech_earth_diplomacy_dlc05	外交	true
technology_node_sets_localised_name_hv_tech_earth_trade_dlc05	贸易	true
technology_node_sets_localised_name_hv_tech_earth_spy_dlc05	细作	true
technology_node_sets_localised_name_hv_tech_fire_peasant_dlc05	农业	true
technology_node_sets_localised_name_hv_tech_fire_merchant_dlc05	商贾	true
technology_node_sets_localised_name_hv_tech_fire_artisan_dlc05	匠师	true
technology_node_sets_localised_name_hv_tech_fire_strategy_dlc05	军师	true
technology_node_sets_localised_name_hv_tech_fire_philosophy_dlc05	哲学	true
technology_node_sets_localised_name_hv_tech_fire_administration_dlc05	官府	true
technology_node_sets_localised_name_hv_tech_fire_army_dlc05	军队	true
technology_node_sets_localised_name_hv_tech_fire_general_dlc05	将领	true
technology_node_sets_localised_name_hv_tech_fire_diplomacy_dlc05	外交	true
technology_node_sets_localised_name_hv_tech_fire_trade_dlc05	贸易	true
technology_node_sets_localised_name_hv_tech_fire_spy_dlc05	细作	true
technology_node_sets_localised_name_hv_tech_metal_peasant_dlc05	农业	true
technology_node_sets_localised_name_hv_tech_metal_merchant_dlc05	商贾	true
technology_node_sets_localised_name_hv_tech_metal_artisan_dlc05	匠师	true
technology_node_sets_localised_name_hv_tech_metal_strategy_dlc05	军师	true
technology_node_sets_localised_name_hv_tech_metal_philosophy_dlc05	哲学	true
technology_node_sets_localised_name_hv_tech_metal_administration_dlc05	官府	true
technology_node_sets_localised_name_hv_tech_metal_army_dlc05	军队	true
technology_node_sets_localised_name_hv_tech_metal_general_dlc05	将领	true
technology_node_sets_localised_name_hv_tech_metal_diplomacy_dlc05	外交	true
technology_node_sets_localised_name_hv_tech_metal_trade_dlc05	贸易	true
technology_node_sets_localised_name_hv_tech_metal_spy_dlc05	细作	true
technology_node_sets_localised_name_hv_tech_water_peasant_dlc05	农业	true
technology_node_sets_localised_name_hv_tech_water_merchant_dlc05	商贾	true
technology_node_sets_localised_name_hv_tech_water_artisan_dlc05	匠师	true
technology_node_sets_localised_name_hv_tech_water_strategy_dlc05	军师	true
technology_node_sets_localised_name_hv_tech_water_philosophy_dlc05	哲学	true
technology_node_sets_localised_name_hv_tech_water_administration_dlc05	官府	true
technology_node_sets_localised_name_hv_tech_water_army_dlc05	军队	true
technology_node_sets_localised_name_hv_tech_water_general_dlc05	将领	true
technology_node_sets_localised_name_hv_tech_water_diplomacy_dlc05	外交	true
technology_node_sets_localised_name_hv_tech_water_trade_dlc05	贸易	true
technology_node_sets_localised_name_hv_tech_water_spy_dlc05	细作	true
technology_node_sets_localised_name_hv_tech_wood_peasant_dlc05	农业	true
technology_node_sets_localised_name_hv_tech_wood_merchant_dlc05	商贾	true
technology_node_sets_localised_name_hv_tech_wood_artisan_dlc05	匠师	true
technology_node_sets_localised_name_hv_tech_wood_strategy_dlc05	军师	true
technology_node_sets_localised_name_hv_tech_wood_philosophy_dlc05	哲学	true
technology_node_sets_localised_name_hv_tech_wood_administration_dlc05	官府	true
technology_node_sets_localised_name_hv_tech_wood_army_dlc05	军队	true
technology_node_sets_localised_name_hv_tech_wood_general_dlc05	将领	true
technology_node_sets_localised_name_hv_tech_wood_diplomacy_dlc05	外交	true
technology_node_sets_localised_name_hv_tech_wood_trade_dlc05	贸易	true
technology_node_sets_localised_name_hv_tech_wood_spy_dlc05	细作	true
