key	text	tooltip
#Loc;1;text/!@hv_TEXT_SKILLSETS_ABILITY_fire.loc		
character_skills_localised_description_hv_skill_ability_rage_of_lu_bu	画戟猛烈地横扫，打击吕布周围的所有敌人	true
character_skills_localised_name_hv_skill_ability_rage_of_lu_bu	人中吕布	true
effects_description_hv_effect_unlock_rage_of_lu_bu	技能：人中吕布	true
special_ability_phases_onscreen_name_hv_ability_rage_of_lu_bu	人中吕布	true
unit_abilities_onscreen_name_hv_ability_rage_of_lu_bu	人中吕布	true
unit_abilities_tooltip_text_hv_ability_rage_of_lu_bu	画戟猛烈地横扫，打击吕布周围的所有敌人	true
unit_ability_types_localised_description_hv_ability_rage_of_lu_bu	人中吕布	true
unit_ability_types_onscreen_name_hv_ability_rage_of_lu_bu	近战杀伤	true
character_skills_localised_description_hv_skill_ability_smouldering_fury	敌人越多，吕布就会越强大！	true
character_skills_localised_name_hv_skill_ability_smouldering_fury	愤懑	true
effects_description_hv_effect_unlock_smouldering_fury	技能：愤懑	true
special_ability_phases_onscreen_name_hv_ability_smouldering_fury_1	愤懑	true
special_ability_phases_onscreen_name_hv_ability_smouldering_fury_2	愤懑	true
special_ability_phases_onscreen_name_hv_ability_smouldering_fury_3	愤懑	true
special_ability_phases_onscreen_name_hv_ability_smouldering_fury_4	愤懑	true
special_ability_phases_onscreen_name_hv_ability_smouldering_fury_5	愤懑	true
unit_abilities_onscreen_name_hv_ability_smouldering_fury	愤懑	true
unit_abilities_tooltip_text_hv_ability_smouldering_fury	敌人越多，吕布就会越强大！	true
unit_ability_types_localised_description_hv_ability_smouldering_fury	愤懑	true
unit_ability_types_onscreen_name_hv_ability_smouldering_fury	被动增益	true
character_skills_localised_description_hv_skill_ability_the_dragon_s_gaze	吕布的狂怒凝视，足以让所有人都畏缩不前！	true
character_skills_localised_name_hv_skill_ability_the_dragon_s_gaze	龙视	true
effects_description_hv_effect_unlock_the_dragon_s_gaze	技能：龙视	true
special_ability_phases_onscreen_name_hv_ability_the_dragon_s_gaze	龙视	true
unit_abilities_onscreen_name_hv_ability_the_dragon_s_gaze	龙视	true
unit_abilities_tooltip_text_hv_ability_the_dragon_s_gaze	吕布的狂怒凝视，足以让所有人都畏缩不前！	true
unit_ability_types_localised_description_hv_ability_the_dragon_s_gaze	龙视	true
unit_ability_types_onscreen_name_hv_ability_the_dragon_s_gaze	主动减益	true
character_skills_localised_description_hv_skill_ability_reign_of_terror	暴君震怒，属下瑟瑟发抖	true
character_skills_localised_name_hv_skill_ability_reign_of_terror	怖惧	true
effects_description_hv_effect_unlock_reign_of_terror	技能：怖惧	true
special_ability_phases_onscreen_name_hv_ability_reign_of_terror	怖惧	true
unit_abilities_onscreen_name_hv_ability_reign_of_terror	怖惧	true
unit_abilities_tooltip_text_hv_ability_reign_of_terror	暴君震怒，属下瑟瑟发抖	true
unit_ability_types_localised_description_hv_ability_reign_of_terror	怖惧	true
unit_ability_types_onscreen_name_hv_ability_reign_of_terror	被动增益	true
character_skills_localised_description_hv_skill_ability_dong_command	严苛高压的命令。	true
character_skills_localised_name_hv_skill_ability_dong_command	董卓之令	true
effects_description_hv_effect_unlock_dong_command	技能：董卓之令	true
special_ability_phases_onscreen_name_hv_ability_dong_command_1	董卓之令	true
special_ability_phases_onscreen_name_hv_ability_dong_command_2	董卓之令	true
unit_abilities_onscreen_name_hv_ability_dong_command	董卓之令	true
unit_abilities_tooltip_text_hv_ability_dong_command	严苛高压的命令。	true
unit_ability_types_localised_description_hv_ability_dong_command	董卓之令	true
unit_ability_types_onscreen_name_hv_ability_dong_command	主动增益	true
character_skills_localised_description_hv_skill_ability_blade_breaker	望着刀刃徒劳地划过铠甲，暴君不禁朗声大笑	true
character_skills_localised_name_hv_skill_ability_blade_breaker	断刃	true
effects_description_hv_effect_unlock_blade_breaker	技能：断刃	true
special_ability_phases_onscreen_name_hv_ability_blade_breaker	断刃	true
unit_abilities_onscreen_name_hv_ability_blade_breaker	断刃	true
unit_abilities_tooltip_text_hv_ability_blade_breaker	望着刀刃徒劳地划过铠甲，暴君不禁朗声大笑	true
unit_ability_types_localised_description_hv_ability_blade_breaker	断刃	true
unit_ability_types_onscreen_name_hv_ability_blade_breaker	被动增益	true
character_skills_localised_description_hv_skill_ability_blood_fury	孙策的力量增强，同时其自控力也在减弱…	true
character_skills_localised_name_hv_skill_ability_blood_fury	血怒	true
effects_description_hv_effect_unlock_blood_fury	技能：血怒	true
special_ability_phases_onscreen_name_hv_ability_blood_fury	血怒	true
unit_abilities_onscreen_name_hv_ability_blood_fury	血怒	true
unit_abilities_tooltip_text_hv_ability_blood_fury	孙策的力量增强，同时其自控力也在减弱…	true
unit_ability_types_localised_description_hv_ability_blood_fury	血怒	true
unit_ability_types_onscreen_name_hv_ability_blood_fury	被动增益	true
character_skills_localised_description_hv_skill_ability_devastating_roar	以愤怒的怒吼压制敌人士气！	true
character_skills_localised_name_hv_skill_ability_devastating_roar	狂号	true
effects_description_hv_effect_unlock_devastating_roar	技能：狂号	true
special_ability_phases_onscreen_name_hv_ability_devastating_roar	狂号	true
unit_abilities_onscreen_name_hv_ability_devastating_roar	狂号	true
unit_abilities_tooltip_text_hv_ability_devastating_roar	以愤怒的怒吼压制敌人士气！	true
unit_ability_types_localised_description_hv_ability_devastating_roar	狂号	true
unit_ability_types_onscreen_name_hv_ability_devastating_roar	主动减益	true
character_skills_localised_description_hv_skill_ability_heart_seeker	孙仁仅需一击便可致敌于死地	true
character_skills_localised_name_hv_skill_ability_heart_seeker	觅心	true
effects_description_hv_effect_unlock_heart_seeker	技能：觅心	true
special_ability_phases_onscreen_name_hv_ability_heart_seeker	觅心	true
unit_abilities_onscreen_name_hv_ability_heart_seeker	觅心	true
unit_abilities_tooltip_text_hv_ability_heart_seeker	孙仁仅需一击便可致敌于死地	true
unit_ability_types_localised_description_hv_ability_heart_seeker	觅心	true
unit_ability_types_onscreen_name_hv_ability_heart_seeker	远程杀伤	true
character_skills_localised_description_hv_skill_ability_sundering_strike	张飞奋力一击，敌军防御土崩瓦解	true
character_skills_localised_name_hv_skill_ability_sundering_strike	裂斩	true
effects_description_hv_effect_unlock_sundering_strike	技能：	true
special_ability_phases_onscreen_name_hv_ability_sundering_strike	裂斩	true
unit_abilities_onscreen_name_hv_ability_sundering_strike	裂斩	true
unit_abilities_tooltip_text_hv_ability_sundering_strike	张飞奋力一击，敌军防御土崩瓦解	true
unit_ability_types_localised_description_hv_ability_sundering_strike	裂斩	true
unit_ability_types_onscreen_name_hv_ability_sundering_strike	远程杀伤	true
character_skills_localised_description_hv_skill_ability_blazing_roar	张飞仰天怒吼，敌军士气溃散！	true
character_skills_localised_name_hv_skill_ability_blazing_roar	怒吼	true
effects_description_hv_effect_unlock_blazing_roar	技能：怒吼	true
special_ability_phases_onscreen_name_hv_ability_blazing_roar	怒吼	true
unit_abilities_onscreen_name_hv_ability_blazing_roar	怒吼	true
unit_abilities_tooltip_text_hv_ability_blazing_roar	张飞仰天怒吼，敌军士气溃散！	true
unit_ability_types_localised_description_hv_ability_blazing_roar	怒吼	true
unit_ability_types_onscreen_name_hv_ability_blazing_roar	主动减益	true
character_skills_localised_description_hv_skill_ability_internal_blaze	马超心中烈火化作无穷暴怒，奋勇冲锋不能自己！	true
character_skills_localised_name_hv_skill_ability_internal_blaze	心火	true
effects_description_hv_effect_unlock_internal_blaze	技能：心火	true
special_ability_phases_onscreen_name_hv_ability_internal_blaze	心火	true
unit_abilities_onscreen_name_hv_ability_internal_blaze	心火	true
unit_abilities_tooltip_text_hv_ability_internal_blaze	马超心中烈火化作无穷暴怒，奋勇冲锋不能自己！	true
unit_ability_types_localised_description_hv_ability_internal_blaze	心火	true
unit_ability_types_onscreen_name_hv_ability_internal_blaze	被动增益	true
character_skills_localised_description_hv_skill_ability_blazing_saddles	强大力量的冲击，会消耗夏侯渊的注意力	true
character_skills_localised_name_hv_skill_ability_blazing_saddles	绝尘	true
effects_description_hv_effect_unlock_blazing_saddles	技能：绝尘	true
special_ability_phases_onscreen_name_hv_ability_blazing_saddles	绝尘	true
unit_abilities_onscreen_name_hv_ability_blazing_saddles	绝尘	true
unit_abilities_tooltip_text_hv_ability_blazing_saddles	强大力量的冲击，会消耗夏侯渊的注意力	true
unit_ability_types_localised_description_hv_ability_blazing_saddles	绝尘	true
unit_ability_types_onscreen_name_hv_ability_blazing_saddles	被动增益	true
character_skills_localised_description_hv_skill_ability_wildfire	甘宁疾冲之势，如野火飞掠林梢	true
character_skills_localised_name_hv_skill_ability_wildfire	猛火袭掠	true
effects_description_hv_effect_unlock_wildfire	技能：猛火袭掠	true
special_ability_phases_onscreen_name_hv_ability_wildfire_1	猛火袭掠	true
special_ability_phases_onscreen_name_hv_ability_wildfire_2	猛火袭掠	true
special_ability_phases_onscreen_name_hv_ability_wildfire_3	猛火袭掠	true
special_ability_phases_onscreen_name_hv_ability_wildfire_4	猛火袭掠	true
special_ability_phases_onscreen_name_hv_ability_wildfire_5	猛火袭掠	true
unit_abilities_onscreen_name_hv_ability_wildfire	猛火袭掠	true
unit_abilities_tooltip_text_hv_ability_wildfire	甘宁疾冲之势，如野火飞掠林梢	true
unit_ability_types_localised_description_hv_ability_wildfire	猛火袭掠	true
unit_ability_types_onscreen_name_hv_ability_wildfire	被动增益	true
character_skills_localised_description_hv_skill_ability_burning	火势越猛，持烧之时越短。	true
character_skills_localised_name_hv_skill_ability_burning	魂烧	true
effects_description_hv_effect_unlock_burning	技能：魂烧	true
special_ability_phases_onscreen_name_hv_ability_burning	魂烧	true
unit_abilities_onscreen_name_hv_ability_burning	魂烧	true
unit_abilities_tooltip_text_hv_ability_burning	火势越猛，持烧之时越短。	true
unit_ability_types_localised_description_hv_ability_burning	魂烧	true
unit_ability_types_onscreen_name_hv_ability_burning	主动增益	true
character_skills_localised_description_hv_skill_ability_flames_of_the_phoenix	以强大的破坏力掀起毁灭性的怒涛！	true
character_skills_localised_name_hv_skill_ability_flames_of_the_phoenix	炎凤	true
effects_description_hv_effect_unlock_flames_of_the_phoenix	技能：炎凤	true
special_ability_phases_onscreen_name_hv_ability_flames_of_the_phoenix	炎凤	true
unit_abilities_onscreen_name_hv_ability_flames_of_the_phoenix	炎凤	true
unit_abilities_tooltip_text_hv_ability_flames_of_the_phoenix	以强大的破坏力掀起毁灭性的怒涛！	true
unit_ability_types_localised_description_hv_ability_flames_of_the_phoenix	炎凤	true
unit_ability_types_onscreen_name_hv_ability_flames_of_the_phoenix	近战杀伤	true
character_skills_localised_description_hv_skill_ability_fire_bomb	向目标区域投掷一枚毁灭性的爆弹	true
character_skills_localised_name_hv_skill_ability_fire_bomb	火焰弹	true
effects_description_hv_effect_unlock_fire_bomb	技能：火焰弹	true
special_ability_phases_onscreen_name_hv_ability_fire_bomb	火焰弹	true
unit_abilities_onscreen_name_hv_ability_fire_bomb	火焰弹	true
unit_abilities_tooltip_text_hv_ability_fire_bomb	向目标区域投掷一枚毁灭性的爆弹	true
unit_ability_types_localised_description_hv_ability_fire_bomb	火焰弹	true
unit_ability_types_onscreen_name_hv_ability_fire_bomb	远程杀伤	true
character_skills_localised_description_hv_skill_ability_aggressive anger	此乃怒不可抑。	true
character_skills_localised_name_hv_skill_ability_aggressive anger	洪荒之力	true
effects_description_hv_effect_unlock_aggressive anger	技能：洪荒之力	true
special_ability_phases_onscreen_name_hv_ability_aggressive anger_1	洪荒之力	true
special_ability_phases_onscreen_name_hv_ability_aggressive anger_2	洪荒之力	true
special_ability_phases_onscreen_name_hv_ability_aggressive anger_3	洪荒之力	true
special_ability_phases_onscreen_name_hv_ability_aggressive anger_4	洪荒之力	true
special_ability_phases_onscreen_name_hv_ability_aggressive anger_5	洪荒之力	true
unit_abilities_onscreen_name_hv_ability_aggressive anger	洪荒之力	true
unit_abilities_tooltip_text_hv_ability_aggressive anger	此乃怒不可抑。	true
unit_ability_types_localised_description_hv_ability_aggressive anger	洪荒之力	true
unit_ability_types_onscreen_name_hv_ability_aggressive anger	被动增益	true
character_skills_localised_description_hv_skill_ability_roar_of_the_beast	百胜之将的怒火，将何等的可怕！	true
character_skills_localised_name_hv_skill_ability_roar_of_the_beast	虎啸	true
effects_description_hv_effect_unlock_roar_of_the_beast	技能：虎啸	true
special_ability_phases_onscreen_name_hv_ability_roar_of_the_beast	虎啸	true
unit_abilities_onscreen_name_hv_ability_roar_of_the_beast	虎啸	true
unit_abilities_tooltip_text_hv_ability_roar_of_the_beast	百胜之将的怒火，将何等的可怕！	true
unit_ability_types_localised_description_hv_ability_roar_of_the_beast	虎啸	true
unit_ability_types_onscreen_name_hv_ability_roar_of_the_beast	主动减益	true
character_skills_localised_description_hv_skill_ability_tracking	仅少数人可逃过此人的追猎。	true
character_skills_localised_name_hv_skill_ability_tracking	追猎	true
effects_description_hv_effect_unlock_tracking	技能：追猎	true
special_ability_phases_onscreen_name_hv_ability_tracking	追猎	true
unit_abilities_onscreen_name_hv_ability_tracking	追猎	true
unit_abilities_tooltip_text_hv_ability_tracking	仅少数人可逃过此人的追猎。	true
unit_ability_types_localised_description_hv_ability_tracking	追猎	true
unit_ability_types_onscreen_name_hv_ability_tracking	被动增益	true
character_skills_localised_description_hv_skill_ability_meteor_hammer	使敌人无法动弹的投掷武器。	true
character_skills_localised_name_hv_skill_ability_meteor_hammer	流星锤	true
effects_description_hv_effect_unlock_meteor_hammer	技能：流星锤	true
special_ability_phases_onscreen_name_hv_ability_meteor_hammer	流星锤	true
unit_abilities_onscreen_name_hv_ability_meteor_hammer	流星锤	true
unit_abilities_tooltip_text_hv_ability_meteor_hammer	使敌人无法动弹的投掷武器。	true
unit_ability_types_localised_description_hv_ability_meteor_hammer	流星锤	true
unit_ability_types_onscreen_name_hv_ability_meteor_hammer	远程杀伤	true
character_skills_localised_description_hv_skill_ability_contempt_for_the_weak	眨眼间就令敌人溃逃。	true
character_skills_localised_name_hv_skill_ability_contempt_for_the_weak	横扫	true
effects_description_hv_effect_unlock_contempt_for_the_weak	技能：横扫	true
special_ability_phases_onscreen_name_hv_ability_contempt_for_the_weak	横扫	true
unit_abilities_onscreen_name_hv_ability_contempt_for_the_weak	横扫	true
unit_abilities_tooltip_text_hv_ability_contempt_for_the_weak	眨眼间就令敌人溃逃。	true
unit_ability_types_localised_description_hv_ability_contempt_for_the_weak	横扫	true
unit_ability_types_onscreen_name_hv_ability_contempt_for_the_weak	远程杀伤	true
character_skills_localised_description_hv_skill_ability_breakthrough	没有任何枪阵可挡下此人的冲锋。	true
character_skills_localised_name_hv_skill_ability_breakthrough	特点冲锋	true
effects_description_hv_effect_unlock_breakthrough	技能：特点冲锋	true
special_ability_phases_onscreen_name_hv_ability_breakthrough	特点冲锋	true
unit_abilities_onscreen_name_hv_ability_breakthrough	特点冲锋	true
unit_abilities_tooltip_text_hv_ability_breakthrough	没有任何枪阵可挡下此人的冲锋。	true
unit_ability_types_localised_description_hv_ability_breakthrough	特点冲锋	true
unit_ability_types_onscreen_name_hv_ability_breakthrough	被动增强效果	true
character_skills_localised_description_hv_skill_ability_breakthrough_resolve	没有任何枪阵可挡下此人的冲锋。	true
character_skills_localised_name_hv_skill_ability_breakthrough_resolve	特点冲锋	true
character_skills_localised_description_hv_skill_ability_scattering_blows	迅猛而一致的攻击，如狂风暴雨般席卷敌军。	true
character_skills_localised_name_hv_skill_ability_scattering_blows	诛荡	true
effects_description_hv_effect_unlock_scattering_blows	技能：诛荡	true
special_ability_phases_onscreen_name_hv_ability_scattering_blows	诛荡	true
unit_abilities_onscreen_name_hv_ability_scattering_blows	诛荡	true
unit_abilities_tooltip_text_hv_ability_scattering_blows	迅猛而一致的攻击，如狂风暴雨般席卷敌军。	true
unit_ability_types_localised_description_hv_ability_scattering_blows	诛荡	true
unit_ability_types_onscreen_name_hv_ability_scattering_blows	主动增益	true
character_skills_localised_description_hv_skill_ability_undying_vow	他们将坚定不移、视死如归，奋战到流尽最后一滴血。	true
character_skills_localised_name_hv_skill_ability_undying_vow	守誓	true
effects_description_hv_effect_unlock_undying_vow	技能：守誓	true
special_ability_phases_onscreen_name_hv_ability_undying_vow	守誓	true
unit_abilities_onscreen_name_hv_ability_undying_vow	守誓	true
unit_abilities_tooltip_text_hv_ability_undying_vow	他们将坚定不移、视死如归，奋战到流尽最后一滴血。	true
unit_ability_types_localised_description_hv_ability_undying_vow	守誓	true
unit_ability_types_onscreen_name_hv_ability_undying_vow	被动增益	true
character_skills_localised_description_hv_skill_ability_contempt_for_the_weak_scholar	眨眼间就令敌人溃逃。	true
character_skills_localised_name_hv_skill_ability_contempt_for_the_weak_scholar	横扫	true
