key	text	tooltip
#Loc;1;text/_hvo/hv_TEXT_skills_skill_ability__historical.loc		
character_skills_localised_description_hv_historical_skill_ability_earth_01	A clash is inevitable.	true
character_skills_localised_name_hv_historical_skill_ability_earth_01	A Storm of Swords	true
effects_description_hv_effects_unlock_historical_ability_earth_01	Ability: A Storm of Swords	true
special_ability_phases_onscreen_name_hv_historical_ability_earth_01	A Storm of Swords	true
unit_abilities_onscreen_name_hv_historical_ability_earth_01	A Storm of Swords	true
unit_abilities_tooltip_text_hv_historical_ability_earth_01	A clash is inevitable.	true
unit_ability_types_localised_description_hv_historical_ability_earth_01	A Storm of Swords	true
unit_ability_types_onscreen_name_hv_historical_ability_earth_01	Active Buff	true
character_skills_localised_description_hv_historical_skill_ability_earth_02	With skin of earth, arrows rebound, harmless.	true
character_skills_localised_name_hv_historical_skill_ability_earth_02	Stone Bulwark	true
effects_description_hv_effects_unlock_historical_ability_earth_02	Ability: Stone Bulwark	true
special_ability_phases_onscreen_name_hv_historical_ability_earth_02	Stone Bulwark	true
unit_abilities_onscreen_name_hv_historical_ability_earth_02	Stone Bulwark	true
unit_abilities_tooltip_text_hv_historical_ability_earth_02	With skin of earth, arrows rebound, harmless.	true
unit_ability_types_localised_description_hv_historical_ability_earth_02	Stone Bulwark	true
unit_ability_types_onscreen_name_hv_historical_ability_earth_02	Active Buff	true
character_skills_localised_description_hv_historical_skill_ability_earth_03	Soldiers gather under the banner of this hero.	true
character_skills_localised_name_hv_historical_skill_ability_earth_03	Assemble	true
effects_description_hv_effects_unlock_historical_ability_earth_03	Ability: Assemble	true
special_ability_phases_onscreen_name_hv_historical_ability_earth_03	Assemble	true
unit_abilities_onscreen_name_hv_historical_ability_earth_03	Assemble	true
unit_abilities_tooltip_text_hv_historical_ability_earth_03	Soldiers gather under the banner of this hero.	true
unit_ability_types_localised_description_hv_historical_ability_earth_03	Assemble	true
unit_ability_types_onscreen_name_hv_historical_ability_earth_03	Passive Buff	true
character_skills_localised_description_hv_historical_skill_ability_metal_01	A war cry from one warrior to another.	true
character_skills_localised_name_hv_historical_skill_ability_metal_01	Commanding Shout	true
effects_description_hv_effects_unlock_historical_ability_metal_01	Ability: Commanding Shout	true
special_ability_phases_onscreen_name_hv_historical_ability_metal_01	Commanding Shout	true
unit_abilities_onscreen_name_hv_historical_ability_metal_01	Commanding Shout	true
unit_abilities_tooltip_text_hv_historical_ability_metal_01	A war cry from one warrior to another.	true
unit_ability_types_localised_description_hv_historical_ability_metal_01	Commanding Shout	true
unit_ability_types_onscreen_name_hv_historical_ability_metal_01	Active Buff	true
character_skills_localised_description_hv_historical_skill_ability_metal_02	This hero believes you can only kill that which you can catch.	true
character_skills_localised_name_hv_historical_skill_ability_metal_02	Fleet-footed	true
effects_description_hv_effects_unlock_historical_ability_metal_02	Ability: Fleet-footed	true
special_ability_phases_onscreen_name_hv_historical_ability_metal_02	Fleet-footed	true
unit_abilities_onscreen_name_hv_historical_ability_metal_02	Fleet-footed	true
unit_abilities_tooltip_text_hv_historical_ability_metal_02	This hero believes you can only kill that which you can catch.	true
unit_ability_types_localised_description_hv_historical_ability_metal_02	Fleet-footed	true
unit_ability_types_onscreen_name_hv_historical_ability_metal_02	Active Buff	true
character_skills_localised_description_hv_historical_skill_ability_metal_03	The forest provides a path, and surer footing, for the respectful.	true
character_skills_localised_name_hv_historical_skill_ability_metal_03	Nature's Ally	true
effects_description_hv_effects_unlock_historical_ability_metal_03	Ability: Nature's Ally	true
special_ability_phases_onscreen_name_hv_historical_ability_metal_03	Nature's Ally	true
unit_abilities_onscreen_name_hv_historical_ability_metal_03	Nature's Ally	true
unit_abilities_tooltip_text_hv_historical_ability_metal_03	The forest provides a path, and surer footing, for the respectful.	true
unit_ability_types_localised_description_hv_historical_ability_metal_03	Nature's Ally	true
unit_ability_types_onscreen_name_hv_historical_ability_metal_03	Active Buff	true
character_skills_localised_description_hv_historical_skill_ability_wood_01	An immovable mountain against the tide of the charge.	true
character_skills_localised_name_hv_historical_skill_ability_wood_01	Earthen Rampart	true
effects_description_hv_effects_unlock_historical_ability_wood_01	Ability: Earthen Rampart	true
special_ability_phases_onscreen_name_hv_historical_ability_wood_01	Earthen Rampart	true
unit_abilities_onscreen_name_hv_historical_ability_wood_01	Earthen Rampart	true
unit_abilities_tooltip_text_hv_historical_ability_wood_01	An immovable mountain against the tide of the charge.	true
unit_ability_types_localised_description_hv_historical_ability_wood_01	Earthen Rampart	true
unit_ability_types_onscreen_name_hv_historical_ability_wood_01	Active Buff	true
character_skills_localised_description_hv_historical_skill_ability_wood_02	The longer this warrior fights, the stronger they become!	true
character_skills_localised_name_hv_historical_skill_ability_wood_02	Tenacity of Steel	true
effects_description_hv_effects_unlock_historical_ability_wood_02	Ability: Tenacity of Steel	true
special_ability_phases_onscreen_name_hv_historical_ability_wood_02_1	Tenacity of Steel	true
special_ability_phases_onscreen_name_hv_historical_ability_wood_02_2	Tenacity of Steel	true
special_ability_phases_onscreen_name_hv_historical_ability_wood_02_3	Tenacity of Steel	true
unit_abilities_onscreen_name_hv_historical_ability_wood_02	Tenacity of Steel	true
unit_abilities_tooltip_text_hv_historical_ability_wood_02	The longer this warrior fights, the stronger they become!	true
unit_ability_types_localised_description_hv_historical_ability_wood_02	Tenacity of Steel	true
unit_ability_types_onscreen_name_hv_historical_ability_wood_02	Passive Buff	true
character_skills_localised_description_hv_historical_skill_ability_wood_03	A warrior who feels truly alive in battle.	true
character_skills_localised_name_hv_historical_skill_ability_wood_03	Inner Vitality	true
effects_description_hv_effects_unlock_historical_ability_wood_03	Ability: Inner Vitality	true
special_ability_phases_onscreen_name_hv_historical_ability_wood_03	Inner Vitality	true
unit_abilities_onscreen_name_hv_historical_ability_wood_03	Inner Vitality	true
unit_abilities_tooltip_text_hv_historical_ability_wood_03	A warrior who feels truly alive in battle.	true
unit_ability_types_localised_description_hv_historical_ability_wood_03	Inner Vitality	true
unit_ability_types_onscreen_name_hv_historical_ability_wood_03	Passive Buff	true
character_skills_localised_description_hv_historical_skill_ability_water_01	Inspirational deeds spur forces to swifter action!	true
character_skills_localised_name_hv_historical_skill_ability_water_01	Inspiring Surge	true
effects_description_hv_effects_unlock_historical_ability_water_01	Ability: Inspiring Surge	true
special_ability_phases_onscreen_name_hv_historical_ability_water_01	Inspiring Surge	true
unit_abilities_onscreen_name_hv_historical_ability_water_01	Inspiring Surge	true
unit_abilities_tooltip_text_hv_historical_ability_water_01	Inspirational deeds spur forces to swifter action!	true
unit_ability_types_localised_description_hv_historical_ability_water_01	Inspiring Surge	true
unit_ability_types_onscreen_name_hv_historical_ability_water_01	Passive Buff	true
character_skills_localised_description_hv_historical_skill_ability_water_02	Organised volleys prove more effective.	true
character_skills_localised_name_hv_historical_skill_ability_water_02	Fire Control	true
effects_description_hv_effects_unlock_historical_ability_water_02	Ability: Fire Control	true
special_ability_phases_onscreen_name_hv_historical_ability_water_02	Fire Control	true
unit_abilities_onscreen_name_hv_historical_ability_water_02	Fire Control	true
unit_abilities_tooltip_text_hv_historical_ability_water_02	Organised volleys prove more effective.	true
unit_ability_types_localised_description_hv_historical_ability_water_02	Fire Control	true
unit_ability_types_onscreen_name_hv_historical_ability_water_02	Active Buff	true
character_skills_localised_description_hv_historical_skill_ability_water_03	Organise your troops into a solid wall to deter horses. It's a simple but effective tactic.	true
character_skills_localised_name_hv_historical_skill_ability_water_03	Anti-Cavalry Tactics	true
effects_description_hv_effects_unlock_historical_ability_water_03	Ability: Anti-Cavalry Tactics	true
special_ability_phases_onscreen_name_hv_historical_ability_water_03	Anti-Cavalry Tactics	true
unit_abilities_onscreen_name_hv_historical_ability_water_03	Anti-Cavalry Tactics	true
unit_abilities_tooltip_text_hv_historical_ability_water_03	Organise your troops into a solid wall to deter horses. It's a simple but effective tactic.	true
unit_ability_types_localised_description_hv_historical_ability_water_03	Anti-Cavalry Tactics	true
unit_ability_types_onscreen_name_hv_historical_ability_water_03	Passive Buff	true
character_skills_localised_description_hv_historical_skill_ability_fire_01	A charge, fuelled by stern hearts and sterner blades, will rip enemy lines apart.	true
character_skills_localised_name_hv_historical_skill_ability_fire_01	Into the Breach	true
effects_description_hv_effects_unlock_historical_ability_fire_01	Ability: Into the Breach	true
special_ability_phases_onscreen_name_hv_historical_ability_fire_01	Into the Breach	true
unit_abilities_onscreen_name_hv_historical_ability_fire_01	Into the Breach	true
unit_abilities_tooltip_text_hv_historical_ability_fire_01	A charge, fuelled by stern hearts and sterner blades, will rip enemy lines apart.	true
unit_ability_types_localised_description_hv_historical_ability_fire_01	Into the Breach	true
unit_ability_types_onscreen_name_hv_historical_ability_fire_01	Active Buff	true
character_skills_localised_description_hv_historical_skill_ability_fire_02	A devastating swing with the power of the risen inferno!	true
character_skills_localised_name_hv_historical_skill_ability_fire_02	Flames of the Phoenix	true
effects_description_hv_effects_unlock_historical_ability_fire_02	Ability: Flames of the Phoenix	true
special_ability_phases_onscreen_name_hv_historical_ability_fire_02	Flames of the Phoenix	true
unit_abilities_onscreen_name_hv_historical_ability_fire_02	Flames of the Phoenix	true
unit_abilities_tooltip_text_hv_historical_ability_fire_02	A devastating swing with the power of the risen inferno!	true
unit_ability_types_localised_description_hv_historical_ability_fire_02	Flames of the Phoenix	true
unit_ability_types_onscreen_name_hv_historical_ability_fire_02	Active Buff	true
character_skills_localised_description_hv_historical_skill_ability_fire_03	Few can escape this warrior's pursuit.	true
character_skills_localised_name_hv_historical_skill_ability_fire_03	Tracker	true
effects_description_hv_effects_unlock_historical_ability_fire_03	Ability: Tracker	true
special_ability_phases_onscreen_name_hv_historical_ability_fire_03	Tracker	true
unit_abilities_onscreen_name_hv_historical_ability_fire_03	Tracker	true
unit_abilities_tooltip_text_hv_historical_ability_fire_03	Few can escape this warrior's pursuit.	true
unit_ability_types_localised_description_hv_historical_ability_fire_03	Tracker	true
unit_ability_types_onscreen_name_hv_historical_ability_fire_03	Passive Buff	true
character_skills_localised_description_hv_historical_skill_ability_healer_01	This hero believes you can only kill that which you can catch.	true
character_skills_localised_name_hv_historical_skill_ability_healer_01	Fleet-footed	true
effects_description_hv_effects_unlock_historical_ability_healer_01	Ability: Fleet-footed	true
special_ability_phases_onscreen_name_hv_historical_ability_healer_01	Fleet-footed	true
unit_abilities_onscreen_name_hv_historical_ability_healer_01	Fleet-footed	true
unit_abilities_tooltip_text_hv_historical_ability_healer_01	This hero believes you can only kill that which you can catch.	true
unit_ability_types_localised_description_hv_historical_ability_healer_01	Fleet-footed	true
unit_ability_types_onscreen_name_hv_historical_ability_healer_01	Active Buff	true
character_skills_localised_description_hv_historical_skill_ability_healer_02	A charge, fuelled by stern hearts and sterner blades, that will rip enemy lines apart.	true
character_skills_localised_name_hv_historical_skill_ability_healer_02	Into the Breach	true
effects_description_hv_effects_unlock_historical_ability_healer_02	Ability: Into the Breach	true
special_ability_phases_onscreen_name_hv_historical_ability_healer_02	Into the Breach	true
unit_abilities_onscreen_name_hv_historical_ability_healer_02	Into the Breach	true
unit_abilities_tooltip_text_hv_historical_ability_healer_02	A charge, fuelled by stern hearts and sterner blades, that will rip enemy lines apart.	true
unit_ability_types_localised_description_hv_historical_ability_healer_02	Into the Breach	true
unit_ability_types_onscreen_name_hv_historical_ability_healer_02	Active Buff	true
character_skills_localised_description_hv_historical_skill_ability_healer_03	Knowledge that your comrades will never abandon you brings tremendous comfort.	true
character_skills_localised_name_hv_historical_skill_ability_healer_03	One with the People	true
effects_description_hv_effects_unlock_historical_ability_healer_03	Ability: One with the People	true
special_ability_phases_onscreen_name_hv_historical_ability_healer_03	One with the People	true
unit_abilities_onscreen_name_hv_historical_ability_healer_03	One with the People	true
unit_abilities_tooltip_text_hv_historical_ability_healer_03	Knowledge that your comrades will never abandon you brings tremendous comfort.	true
unit_ability_types_localised_description_hv_historical_ability_healer_03	One with the People	true
unit_ability_types_onscreen_name_hv_historical_ability_healer_03	Passive Buff	true
character_skills_localised_description_hv_historical_skill_ability_veteran_01	The forest provides a path, and surer footing, for the respectful.	true
character_skills_localised_name_hv_historical_skill_ability_veteran_01	Nature's Ally	true
effects_description_hv_effects_unlock_historical_ability_veteran_01	Ability: Nature's Ally	true
special_ability_phases_onscreen_name_hv_historical_ability_veteran_01	Nature's Ally	true
unit_abilities_onscreen_name_hv_historical_ability_veteran_01	Nature's Ally	true
unit_abilities_tooltip_text_hv_historical_ability_veteran_01	The forest provides a path, and surer footing, for the respectful.	true
unit_ability_types_localised_description_hv_historical_ability_veteran_01	Nature's Ally	true
unit_ability_types_onscreen_name_hv_historical_ability_veteran_01	Active Buff	true
character_skills_localised_description_hv_historical_skill_ability_veteran_02	Generations working the land will breed a kinship with it.	true
character_skills_localised_name_hv_historical_skill_ability_veteran_02	One with the Land	true
effects_description_hv_effects_unlock_historical_ability_veteran_02	Ability: One with the Land	true
special_ability_phases_onscreen_name_hv_historical_ability_veteran_02	One with the Land	true
unit_abilities_onscreen_name_hv_historical_ability_veteran_02	One with the Land	true
unit_abilities_tooltip_text_hv_historical_ability_veteran_02	Generations working the land will breed a kinship with it.	true
unit_ability_types_localised_description_hv_historical_ability_veteran_02	One with the Land	true
unit_ability_types_onscreen_name_hv_historical_ability_veteran_02	Active Buff	true
character_skills_localised_description_hv_historical_skill_ability_veteran_03	Organise your troops into a solid wall to deter horses. It's a simple but effective tactic.	true
character_skills_localised_name_hv_historical_skill_ability_veteran_03	Anti-Cavalry Tactics	true
effects_description_hv_effects_unlock_historical_ability_veteran_03	Ability: Anti-Cavalry Tactics	true
special_ability_phases_onscreen_name_hv_historical_ability_veteran_03	Anti-Cavalry Tactics	true
unit_abilities_onscreen_name_hv_historical_ability_veteran_03	Anti-Cavalry Tactics	true
unit_abilities_tooltip_text_hv_historical_ability_veteran_03	Organise your troops into a solid wall to deter horses. It's a simple but effective tactic.	true
unit_ability_types_localised_description_hv_historical_ability_veteran_03	Anti-Cavalry Tactics	true
unit_ability_types_onscreen_name_hv_historical_ability_veteran_03	Passive Buff	true
character_skills_localised_description_hv_historical_skill_ability_scholar_01	Look up and you will see the sky; look inward and you will see heaven.	true
character_skills_localised_name_hv_historical_skill_ability_scholar_01	One with Heaven	true
effects_description_hv_effects_unlock_historical_ability_scholar_01	Ability: One with Heaven	true
special_ability_phases_onscreen_name_hv_historical_ability_scholar_01	One with Heaven	true
unit_abilities_onscreen_name_hv_historical_ability_scholar_01	One with Heaven	true
unit_abilities_tooltip_text_hv_historical_ability_scholar_01	Look up and you will see the sky; look inward and you will see heaven.	true
unit_ability_types_localised_description_hv_historical_ability_scholar_01	One with Heaven	true
unit_ability_types_onscreen_name_hv_historical_ability_scholar_01	Active Buff	true
character_skills_localised_description_hv_historical_skill_ability_scholar_02	With skin of earth, arrows rebound, harmless.	true
character_skills_localised_name_hv_historical_skill_ability_scholar_02	Stone Bulwark	true
effects_description_hv_effects_unlock_historical_ability_scholar_02	Ability: Stone Bulwark	true
special_ability_phases_onscreen_name_hv_historical_ability_scholar_02	Stone Bulwark	true
unit_abilities_onscreen_name_hv_historical_ability_scholar_02	Stone Bulwark	true
unit_abilities_tooltip_text_hv_historical_ability_scholar_02	With skin of earth, arrows rebound, harmless.	true
unit_ability_types_localised_description_hv_historical_ability_scholar_02	Stone Bulwark	true
unit_ability_types_onscreen_name_hv_historical_ability_scholar_02	Active Buff	true
character_skills_localised_description_hv_historical_skill_ability_scholar_03	A single shot, timed and aimed to perfection, outweighs a thousand wasted volleys.	true
character_skills_localised_name_hv_historical_skill_ability_scholar_03	Targeted Strikes	true
effects_description_hv_effects_unlock_historical_ability_scholar_03	Ability: Targeted Strikes	true
special_ability_phases_onscreen_name_hv_historical_ability_scholar_03	Targeted Strikes	true
unit_abilities_onscreen_name_hv_historical_ability_scholar_03	Targeted Strikes	true
unit_abilities_tooltip_text_hv_historical_ability_scholar_03	A single shot, timed and aimed to perfection, outweighs a thousand wasted volleys.	true
unit_ability_types_localised_description_hv_historical_ability_scholar_03	Targeted Strikes	true
unit_ability_types_onscreen_name_hv_historical_ability_scholar_03	Active Debuff	true
